"OPTIONID","PICKLISTID","STATUS","EXTERNAL_CODE","OPTVALUE"
"1","addressType","2","business","-1"
"2","addressType","0","home","-1"
"3","depositType","0","balance","-1"
"4","depositType","0","flat","-1"
"5","depositType","0","percentage","-1"
"290","ISOCountryList","2","AFG","-1"
"291","ISOCountryList","2","ALB","-1"
"292","ISOCountryList","2","DZA","-1"
"293","ISOCountryList","2","ASM","-1"
"294","ISOCountryList","2","AND","-1"
"295","ISOCountryList","2","AGO","-1"
"296","ISOCountryList","2","AIA","-1"
"297","ISOCountryList","2","ATA","-1"
"298","ISOCountryList","2","ATG","-1"
"299","ISOCountryList","2","ARG","-1"
"300","ISOCountryList","2","ARM","-1"
"301","ISOCountryList","2","ABW","-1"
"302","ISOCountryList","2","AUS","-1"
"303","ISOCountryList","2","AUT","-1"
"304","ISOCountryList","2","AZE","-1"
"305","ISOCountryList","2","BHS","-1"
"306","ISOCountryList","2","BHR","-1"
"307","ISOCountryList","2","BGD","-1"
"308","ISOCountryList","2","BRB","-1"
"309","ISOCountryList","2","BLR","-1"
"310","ISOCountryList","2","BEL","-1"
"311","ISOCountryList","2","BLZ","-1"
"312","ISOCountryList","2","BEN","-1"
"313","ISOCountryList","2","BMU","-1"
"314","ISOCountryList","2","BTN","-1"
"315","ISOCountryList","2","BOL","-1"
"316","ISOCountryList","2","BIH","-1"
"317","ISOCountryList","2","BWA","-1"
"318","ISOCountryList","2","BVT","-1"
"319","ISOCountryList","2","BRA","-1"
"320","ISOCountryList","2","IOT","-1"
"321","ISOCountryList","2","BRN","-1"
"322","ISOCountryList","2","BGR","-1"
"323","ISOCountryList","2","BFA","-1"
"324","ISOCountryList","2","BDI","-1"
"325","ISOCountryList","2","KHM","-1"
"326","ISOCountryList","2","CMR","-1"
"327","ISOCountryList","2","CAN","-1"
"328","ISOCountryList","2","CPV","-1"
"329","ISOCountryList","2","CYM","-1"
"330","ISOCountryList","2","CAF","-1"
"331","ISOCountryList","2","TCD","-1"
"332","ISOCountryList","2","CHL","-1"
"333","ISOCountryList","2","CHN","-1"
"334","ISOCountryList","2","CXR","-1"
"335","ISOCountryList","2","CCK","-1"
"336","ISOCountryList","2","COL","-1"
"337","ISOCountryList","2","COM","-1"
"338","ISOCountryList","2","COG","-1"
"339","ISOCountryList","2","COD","-1"
"340","ISOCountryList","2","COK","-1"
"341","ISOCountryList","2","CRI","-1"
"342","ISOCountryList","2","HRV","-1"
"343","ISOCountryList","2","CUB","-1"
"344","ISOCountryList","2","CUW","-1"
"345","ISOCountryList","2","CYP","-1"
"346","ISOCountryList","2","CZE","-1"
"347","ISOCountryList","2","CIV","-1"
"348","ISOCountryList","2","DNK","-1"
"349","ISOCountryList","2","DJI","-1"
"350","ISOCountryList","2","DMA","-1"
"351","ISOCountryList","2","DOM","-1"
"352","ISOCountryList","2","ECU","-1"
"353","ISOCountryList","2","EGY","-1"
"354","ISOCountryList","2","SLV","-1"
"355","ISOCountryList","2","GNQ","-1"
"356","ISOCountryList","2","ERI","-1"
"357","ISOCountryList","2","EST","-1"
"358","ISOCountryList","2","ETH","-1"
"359","ISOCountryList","2","FLK","-1"
"360","ISOCountryList","2","FRO","-1"
"361","ISOCountryList","2","FJI","-1"
"362","ISOCountryList","2","FIN","-1"
"363","ISOCountryList","2","FRA","-1"
"364","ISOCountryList","2","GUF","-1"
"365","ISOCountryList","2","PYF","-1"
"366","ISOCountryList","2","ATF","-1"
"367","ISOCountryList","2","GAB","-1"
"368","ISOCountryList","2","GMB","-1"
"369","ISOCountryList","2","GEO","-1"
"370","ISOCountryList","2","DEU","-1"
"371","ISOCountryList","2","GHA","-1"
"372","ISOCountryList","2","GIB","-1"
"373","ISOCountryList","2","GRC","-1"
"374","ISOCountryList","2","GRL","-1"
"375","ISOCountryList","2","GRD","-1"
"376","ISOCountryList","2","GLP","-1"
"377","ISOCountryList","2","GUM","-1"
"378","ISOCountryList","2","GTM","-1"
"379","ISOCountryList","2","GGY","-1"
"380","ISOCountryList","2","GIN","-1"
"381","ISOCountryList","2","GNB","-1"
"382","ISOCountryList","2","GUY","-1"
"383","ISOCountryList","2","HTI","-1"
"384","ISOCountryList","2","HMD","-1"
"385","ISOCountryList","2","VAT","-1"
"386","ISOCountryList","2","HND","-1"
"387","ISOCountryList","2","HKG","-1"
"388","ISOCountryList","2","HUN","-1"
"389","ISOCountryList","2","ISL","-1"
"390","ISOCountryList","2","IND","-1"
"391","ISOCountryList","2","IDN","-1"
"392","ISOCountryList","2","IRN","-1"
"393","ISOCountryList","2","IRQ","-1"
"394","ISOCountryList","2","IRL","-1"
"395","ISOCountryList","2","IMN","-1"
"396","ISOCountryList","2","ISR","-1"
"397","ISOCountryList","2","ITA","-1"
"398","ISOCountryList","2","JAM","-1"
"399","ISOCountryList","2","JPN","-1"
"400","ISOCountryList","2","JEY","-1"
"401","ISOCountryList","2","JOR","-1"
"402","ISOCountryList","2","KAZ","-1"
"403","ISOCountryList","2","KEN","-1"
"404","ISOCountryList","2","KIR","-1"
"405","ISOCountryList","2","PRK","-1"
"406","ISOCountryList","2","KOR","-1"
"407","ISOCountryList","2","XKX","-1"
"408","ISOCountryList","2","KWT","-1"
"409","ISOCountryList","2","KGZ","-1"
"410","ISOCountryList","2","LAO","-1"
"411","ISOCountryList","2","LVA","-1"
"412","ISOCountryList","2","LBN","-1"
"413","ISOCountryList","2","LSO","-1"
"414","ISOCountryList","2","LBR","-1"
"415","ISOCountryList","2","LBY","-1"
"416","ISOCountryList","2","LIE","-1"
"417","ISOCountryList","2","LTU","-1"
"418","ISOCountryList","2","LUX","-1"
"419","ISOCountryList","2","MAC","-1"
"420","ISOCountryList","2","MKD","-1"
"421","ISOCountryList","2","MDG","-1"
"422","ISOCountryList","2","MWI","-1"
"423","ISOCountryList","2","MYS","-1"
"424","ISOCountryList","2","MDV","-1"
"425","ISOCountryList","2","MLI","-1"
"426","ISOCountryList","2","MLT","-1"
"427","ISOCountryList","2","MHL","-1"
"428","ISOCountryList","2","MTQ","-1"
"429","ISOCountryList","2","MRT","-1"
"430","ISOCountryList","2","MUS","-1"
"431","ISOCountryList","2","MYT","-1"
"432","ISOCountryList","2","MEX","-1"
"433","ISOCountryList","2","FSM","-1"
"434","ISOCountryList","2","MDA","-1"
"435","ISOCountryList","2","MCO","-1"
"436","ISOCountryList","2","MNG","-1"
"437","ISOCountryList","2","MNE","-1"
"438","ISOCountryList","2","MSR","-1"
"439","ISOCountryList","2","MAR","-1"
"440","ISOCountryList","2","MOZ","-1"
"441","ISOCountryList","2","MMR","-1"
"442","ISOCountryList","2","NAM","-1"
"443","ISOCountryList","2","NRU","-1"
"444","ISOCountryList","2","NPL","-1"
"445","ISOCountryList","2","NLD","-1"
"446","ISOCountryList","2","ANT","-1"
"447","ISOCountryList","2","NCL","-1"
"448","ISOCountryList","2","NZL","-1"
"449","ISOCountryList","2","NIC","-1"
"450","ISOCountryList","2","NER","-1"
"451","ISOCountryList","2","NGA","-1"
"452","ISOCountryList","2","NIU","-1"
"453","ISOCountryList","2","NFK","-1"
"454","ISOCountryList","2","MNP","-1"
"455","ISOCountryList","2","NOR","-1"
"456","ISOCountryList","2","OMN","-1"
"457","ISOCountryList","2","PAK","-1"
"458","ISOCountryList","2","PLW","-1"
"459","ISOCountryList","2","PSE","-1"
"460","ISOCountryList","2","PAN","-1"
"461","ISOCountryList","2","PNG","-1"
"462","ISOCountryList","2","PRY","-1"
"463","ISOCountryList","2","PER","-1"
"464","ISOCountryList","2","PHL","-1"
"465","ISOCountryList","2","PCN","-1"
"466","ISOCountryList","2","POL","-1"
"467","ISOCountryList","2","PRT","-1"
"468","ISOCountryList","2","PRI","-1"
"469","ISOCountryList","2","QAT","-1"
"470","ISOCountryList","2","ROU","-1"
"471","ISOCountryList","2","RUS","-1"
"472","ISOCountryList","2","RWA","-1"
"473","ISOCountryList","2","REU","-1"
"474","ISOCountryList","2","BLM","-1"
"475","ISOCountryList","2","SHN","-1"
"476","ISOCountryList","2","KNA","-1"
"477","ISOCountryList","2","LCA","-1"
"478","ISOCountryList","2","MAF","-1"
"479","ISOCountryList","2","SPM","-1"
"480","ISOCountryList","2","VCT","-1"
"481","ISOCountryList","2","WSM","-1"
"482","ISOCountryList","2","SMR","-1"
"483","ISOCountryList","2","STP","-1"
"484","ISOCountryList","2","SAU","-1"
"485","ISOCountryList","2","SEN","-1"
"486","ISOCountryList","2","SRB","-1"
"487","ISOCountryList","2","SYC","-1"
"488","ISOCountryList","2","SLE","-1"
"489","ISOCountryList","2","SGP","-1"
"490","ISOCountryList","2","SVK","-1"
"491","ISOCountryList","2","SVN","-1"
"492","ISOCountryList","2","SLB","-1"
"493","ISOCountryList","2","SOM","-1"
"494","ISOCountryList","2","ZAF","-1"
"495","ISOCountryList","2","SGS","-1"
"496","ISOCountryList","2","SSD","-1"
"497","ISOCountryList","2","ESP","-1"
"498","ISOCountryList","2","LKA","-1"
"499","ISOCountryList","2","SDN","-1"
"500","ISOCountryList","2","SUR","-1"
"501","ISOCountryList","2","SJM","-1"
"502","ISOCountryList","2","SWZ","-1"
"503","ISOCountryList","2","SWE","-1"
"504","ISOCountryList","2","CHE","-1"
"505","ISOCountryList","2","SYR","-1"
"506","ISOCountryList","2","TWN","-1"
"507","ISOCountryList","2","TJK","-1"
"508","ISOCountryList","2","TZA","-1"
"509","ISOCountryList","2","THA","-1"
"510","ISOCountryList","2","TLS","-1"
"511","ISOCountryList","2","TGO","-1"
"512","ISOCountryList","2","TKL","-1"
"513","ISOCountryList","2","TON","-1"
"514","ISOCountryList","2","TTO","-1"
"515","ISOCountryList","2","TUN","-1"
"516","ISOCountryList","2","TUR","-1"
"517","ISOCountryList","2","TKM","-1"
"518","ISOCountryList","2","TCA","-1"
"519","ISOCountryList","2","TUV","-1"
"520","ISOCountryList","2","UGA","-1"
"521","ISOCountryList","2","UKR","-1"
"522","ISOCountryList","2","ARE","-1"
"523","ISOCountryList","2","GBR","-1"
"524","ISOCountryList","2","USA","-1"
"525","ISOCountryList","2","UMI","-1"
"526","ISOCountryList","2","URY","-1"
"527","ISOCountryList","2","UZB","-1"
"528","ISOCountryList","2","VUT","-1"
"529","ISOCountryList","2","VEN","-1"
"530","ISOCountryList","2","VNM","-1"
"531","ISOCountryList","2","VGB","-1"
"532","ISOCountryList","2","VIR","-1"
"533","ISOCountryList","2","WLF","-1"
"534","ISOCountryList","2","ESH","-1"
"535","ISOCountryList","2","YEM","-1"
"536","ISOCountryList","2","ZMB","-1"
"537","ISOCountryList","2","ZWE","-1"
"538","ISOCountryList","2","ALA","-1"
"545","CANTON_CHE","0","ZH","-1"
"546","CANTON_CHE","0","BE","-1"
"547","CANTON_CHE","0","LU","-1"
"548","CANTON_CHE","0","UR","-1"
"549","CANTON_CHE","0","SZ","-1"
"550","CANTON_CHE","0","OW","-1"
"551","CANTON_CHE","0","NW","-1"
"552","CANTON_CHE","0","GL","-1"
"553","CANTON_CHE","0","ZG","-1"
"554","CANTON_CHE","0","FR","-1"
"555","CANTON_CHE","0","SO","-1"
"556","CANTON_CHE","0","BS","-1"
"557","CANTON_CHE","0","BL","-1"
"558","CANTON_CHE","0","SH","-1"
"559","CANTON_CHE","0","AR","-1"
"560","CANTON_CHE","0","AI","-1"
"561","CANTON_CHE","0","SG","-1"
"562","CANTON_CHE","0","GR","-1"
"563","CANTON_CHE","0","AG","-1"
"564","CANTON_CHE","0","TG","-1"
"565","CANTON_CHE","0","TI","-1"
"566","CANTON_CHE","0","VD","-1"
"567","CANTON_CHE","0","GE","-1"
"568","CANTON_CHE","0","JU","-1"
"569","CANTON_CHE","0","NE","-1"
"570","CANTON_CHE","0","VS","-1"
"571","FLSASTATUS_USA","0","E","-1"
"572","FLSASTATUS_USA","0","N","-1"
"573","FLSASTATUS_USA","0","X","-1"
"574","EEO4CODE_USA","0","1","-1"
"575","EEO4CODE_USA","0","2","-1"
"576","EEO4CODE_USA","0","3","-1"
"577","EEO4CODE_USA","0","4","-1"
"578","EEO4CODE_USA","0","5","-1"
"579","EEO4CODE_USA","0","6","-1"
"580","EEO4CODE_USA","0","7","-1"
"581","EEO4CODE_USA","0","8","-1"
"582","EEO4CODE_USA","0","N","-1"
"609","COUNTY_GBR","0","BKM","-1"
"610","COUNTY_GBR","0","CAM","-1"
"611","COUNTY_GBR","0","CMA","-1"
"612","COUNTY_GBR","0","DBY","-1"
"613","COUNTY_GBR","0","DEV","-1"
"614","COUNTY_GBR","0","DOR","-1"
"615","COUNTY_GBR","0","ESX","-1"
"616","COUNTY_GBR","0","ESS","-1"
"617","COUNTY_GBR","0","GLS","-1"
"618","COUNTY_GBR","0","HAM","-1"
"619","COUNTY_GBR","0","HRT","-1"
"620","COUNTY_GBR","0","KEN","-1"
"621","COUNTY_GBR","0","LAN","-1"
"622","COUNTY_GBR","0","LEC","-1"
"623","COUNTY_GBR","0","LIN","-1"
"624","COUNTY_GBR","0","NFK","-1"
"625","COUNTY_GBR","0","NYK","-1"
"626","COUNTY_GBR","0","NTH","-1"
"627","COUNTY_GBR","0","NTT","-1"
"628","COUNTY_GBR","0","OXF","-1"
"629","COUNTY_GBR","0","SOM","-1"
"630","COUNTY_GBR","0","STS","-1"
"631","COUNTY_GBR","0","SFK","-1"
"632","COUNTY_GBR","0","SRY","-1"
"633","COUNTY_GBR","0","WAR","-1"
"634","COUNTY_GBR","0","WSX","-1"
"635","COUNTY_GBR","0","WOR","-1"
"636","COUNTY_GBR","0","BDG","-1"
"637","COUNTY_GBR","0","BNE","-1"
"638","COUNTY_GBR","0","BEX","-1"
"639","COUNTY_GBR","0","BEN","-1"
"640","COUNTY_GBR","0","BRY","-1"
"641","COUNTY_GBR","0","CMD","-1"
"642","COUNTY_GBR","0","CRY","-1"
"643","COUNTY_GBR","0","EAL","-1"
"644","COUNTY_GBR","0","ENF","-1"
"645","COUNTY_GBR","0","GRE","-1"
"646","COUNTY_GBR","0","HCK","-1"
"647","COUNTY_GBR","0","HMF","-1"
"648","COUNTY_GBR","0","HRY","-1"
"649","COUNTY_GBR","0","HRW","-1"
"650","COUNTY_GBR","0","HAV","-1"
"651","COUNTY_GBR","0","HIL","-1"
"652","COUNTY_GBR","0","HNS","-1"
"653","COUNTY_GBR","0","ISL","-1"
"654","COUNTY_GBR","0","KEC","-1"
"655","COUNTY_GBR","0","KTT","-1"
"656","COUNTY_GBR","0","LBH","-1"
"657","COUNTY_GBR","0","LEW","-1"
"658","COUNTY_GBR","0","MRT","-1"
"659","COUNTY_GBR","0","NWM","-1"
"660","COUNTY_GBR","0","RDB","-1"
"661","COUNTY_GBR","0","RIC","-1"
"662","COUNTY_GBR","0","SWK","-1"
"663","COUNTY_GBR","0","STN","-1"
"664","COUNTY_GBR","0","TWH","-1"
"665","COUNTY_GBR","0","WFT","-1"
"666","COUNTY_GBR","0","WND","-1"
"667","COUNTY_GBR","0","WSM","-1"
"668","COUNTY_GBR","0","BNS","-1"
"669","COUNTY_GBR","0","BIR","-1"
"670","COUNTY_GBR","0","BOL","-1"
"671","COUNTY_GBR","0","BRD","-1"
"672","COUNTY_GBR","0","BUR","-1"
"673","COUNTY_GBR","0","CLD","-1"
"674","COUNTY_GBR","0","COV","-1"
"675","COUNTY_GBR","0","DNC","-1"
"676","COUNTY_GBR","0","DUD","-1"
"677","COUNTY_GBR","0","GAT","-1"
"678","COUNTY_GBR","0","KIR","-1"
"679","COUNTY_GBR","0","KWL","-1"
"680","COUNTY_GBR","0","LDS","-1"
"681","COUNTY_GBR","0","LIV","-1"
"682","COUNTY_GBR","0","MAN","-1"
"683","COUNTY_GBR","0","NET","-1"
"684","COUNTY_GBR","0","NTY","-1"
"685","COUNTY_GBR","0","OLD","-1"
"686","COUNTY_GBR","0","RCH","-1"
"687","COUNTY_GBR","0","ROT","-1"
"688","COUNTY_GBR","0","SHN","-1"
"689","COUNTY_GBR","0","SLF","-1"
"690","COUNTY_GBR","0","SAW","-1"
"691","COUNTY_GBR","0","SFT","-1"
"692","COUNTY_GBR","0","SHF","-1"
"693","COUNTY_GBR","0","SOL","-1"
"694","COUNTY_GBR","0","STY","-1"
"695","COUNTY_GBR","0","SKP","-1"
"696","COUNTY_GBR","0","SND","-1"
"697","COUNTY_GBR","0","TAM","-1"
"698","COUNTY_GBR","0","TRF","-1"
"699","COUNTY_GBR","0","WKF","-1"
"700","COUNTY_GBR","0","WLL","-1"
"701","COUNTY_GBR","0","WGN","-1"
"702","COUNTY_GBR","0","WRL","-1"
"703","COUNTY_GBR","0","WLV","-1"
"704","COUNTY_GBR","0","BAS","-1"
"705","COUNTY_GBR","0","BBD","-1"
"706","COUNTY_GBR","0","BDF","-1"
"707","COUNTY_GBR","0","BPL","-1"
"708","COUNTY_GBR","0","BMH","-1"
"709","COUNTY_GBR","0","BRC","-1"
"710","COUNTY_GBR","0","BNH","-1"
"711","COUNTY_GBR","0","BST","-1"
"712","COUNTY_GBR","0","CBF","-1"
"713","COUNTY_GBR","0","CHE","-1"
"714","COUNTY_GBR","0","CHW","-1"
"715","COUNTY_GBR","0","CON","-1"
"716","COUNTY_GBR","0","DAL","-1"
"717","COUNTY_GBR","0","DER","-1"
"718","COUNTY_GBR","0","DUR","-1"
"719","COUNTY_GBR","0","ERY","-1"
"720","COUNTY_GBR","0","HAL","-1"
"721","COUNTY_GBR","0","HPL","-1"
"722","COUNTY_GBR","0","HEF","-1"
"723","COUNTY_GBR","0","IOW","-1"
"724","COUNTY_GBR","0","KHL","-1"
"725","COUNTY_GBR","0","LCE","-1"
"726","COUNTY_GBR","0","LUT","-1"
"727","COUNTY_GBR","0","MDW","-1"
"728","COUNTY_GBR","0","MDB","-1"
"729","COUNTY_GBR","0","MIK","-1"
"730","COUNTY_GBR","0","NEL","-1"
"731","COUNTY_GBR","0","NLN","-1"
"732","COUNTY_GBR","0","NSM","-1"
"733","COUNTY_GBR","0","NBL","-1"
"734","COUNTY_GBR","0","NGM","-1"
"735","COUNTY_GBR","0","PTE","-1"
"736","COUNTY_GBR","0","PLY","-1"
"737","COUNTY_GBR","0","POL","-1"
"738","COUNTY_GBR","0","POR","-1"
"739","COUNTY_GBR","0","RDG","-1"
"740","COUNTY_GBR","0","RCC","-1"
"741","COUNTY_GBR","0","RUT","-1"
"742","COUNTY_GBR","0","SHR","-1"
"743","COUNTY_GBR","0","SLG","-1"
"744","COUNTY_GBR","0","SGC","-1"
"745","COUNTY_GBR","0","STH","-1"
"746","COUNTY_GBR","0","SOS","-1"
"747","COUNTY_GBR","0","STT","-1"
"748","COUNTY_GBR","0","STE","-1"
"749","COUNTY_GBR","0","SWD","-1"
"750","COUNTY_GBR","0","TFW","-1"
"751","COUNTY_GBR","0","THR","-1"
"752","COUNTY_GBR","0","TOB","-1"
"753","COUNTY_GBR","0","WRT","-1"
"754","COUNTY_GBR","0","WBK","-1"
"755","COUNTY_GBR","0","WIL","-1"
"756","COUNTY_GBR","0","WNM","-1"
"757","COUNTY_GBR","0","WOK","-1"
"758","COUNTY_GBR","0","YOR","-1"
"759","COUNTY_GBR","0","LND","-1"
"760","COUNTY_GBR","0","ANT","-1"
"761","COUNTY_GBR","0","ARD","-1"
"762","COUNTY_GBR","0","ARM","-1"
"763","COUNTY_GBR","0","BLA","-1"
"764","COUNTY_GBR","0","BLY","-1"
"765","COUNTY_GBR","0","BNB","-1"
"766","COUNTY_GBR","0","BFS","-1"
"767","COUNTY_GBR","0","CKF","-1"
"768","COUNTY_GBR","0","CSR","-1"
"769","COUNTY_GBR","0","CLR","-1"
"770","COUNTY_GBR","0","CKT","-1"
"771","COUNTY_GBR","0","CGV","-1"
"772","COUNTY_GBR","0","DRY","-1"
"773","COUNTY_GBR","0","DOW","-1"
"774","COUNTY_GBR","0","DGN","-1"
"775","COUNTY_GBR","0","FER","-1"
"776","COUNTY_GBR","0","LRN","-1"
"777","COUNTY_GBR","0","LMV","-1"
"778","COUNTY_GBR","0","LSB","-1"
"779","COUNTY_GBR","0","MFT","-1"
"780","COUNTY_GBR","0","MYL","-1"
"781","COUNTY_GBR","0","NYM","-1"
"782","COUNTY_GBR","0","NTA","-1"
"783","COUNTY_GBR","0","NDN","-1"
"784","COUNTY_GBR","0","OMH","-1"
"785","COUNTY_GBR","0","STB","-1"
"786","COUNTY_GBR","0","ABE","-1"
"787","COUNTY_GBR","0","ABD","-1"
"788","COUNTY_GBR","0","ANS","-1"
"789","COUNTY_GBR","0","AGB","-1"
"790","COUNTY_GBR","0","CLK","-1"
"791","COUNTY_GBR","0","DGY","-1"
"792","COUNTY_GBR","0","DND","-1"
"793","COUNTY_GBR","0","EAY","-1"
"794","COUNTY_GBR","0","EDU","-1"
"795","COUNTY_GBR","0","ELN","-1"
"796","COUNTY_GBR","0","ERW","-1"
"797","COUNTY_GBR","0","EDH","-1"
"798","COUNTY_GBR","0","ELS","-1"
"799","COUNTY_GBR","0","FAL","-1"
"800","COUNTY_GBR","0","FIF","-1"
"801","COUNTY_GBR","0","GLG","-1"
"802","COUNTY_GBR","0","HLD","-1"
"803","COUNTY_GBR","0","IVC","-1"
"804","COUNTY_GBR","0","MLN","-1"
"805","COUNTY_GBR","0","MRY","-1"
"806","COUNTY_GBR","0","NAY","-1"
"807","COUNTY_GBR","0","NLK","-1"
"808","COUNTY_GBR","0","ORK","-1"
"809","COUNTY_GBR","0","PKN","-1"
"810","COUNTY_GBR","0","RFW","-1"
"811","COUNTY_GBR","0","SCB","-1"
"812","COUNTY_GBR","0","ZET","-1"
"813","COUNTY_GBR","0","SAY","-1"
"814","COUNTY_GBR","0","SLK","-1"
"815","COUNTY_GBR","0","STG","-1"
"816","COUNTY_GBR","0","WDU","-1"
"817","COUNTY_GBR","0","WLN","-1"
"818","COUNTY_GBR","0","BGW","-1"
"819","COUNTY_GBR","0","BGE","-1"
"820","COUNTY_GBR","0","CAY","-1"
"821","COUNTY_GBR","0","CRF","-1"
"822","COUNTY_GBR","0","CMN","-1"
"823","COUNTY_GBR","0","CGN","-1"
"824","COUNTY_GBR","0","CWY","-1"
"825","COUNTY_GBR","0","DEN","-1"
"826","COUNTY_GBR","0","FLN","-1"
"827","COUNTY_GBR","0","GWN","-1"
"828","COUNTY_GBR","0","AGY","-1"
"829","COUNTY_GBR","0","MTY","-1"
"830","COUNTY_GBR","0","MON","-1"
"831","COUNTY_GBR","0","NTL","-1"
"832","COUNTY_GBR","0","NWP","-1"
"833","COUNTY_GBR","0","PEM","-1"
"834","COUNTY_GBR","0","POW","-1"
"835","COUNTY_GBR","0","RCT","-1"
"836","COUNTY_GBR","0","SWA","-1"
"837","COUNTY_GBR","0","TOF","-1"
"838","COUNTY_GBR","0","VGL","-1"
"839","COUNTY_GBR","0","WRX","-1"
"840","JOB_FUNCTION_TYPE","0","AD","-1"
"841","JOB_FUNCTION_TYPE","0","MT","-1"
"842","JOB_FUNCTION_TYPE","0","PR","-1"
"843","JOB_FUNCTION_TYPE","0","DL","-1"
"844","JOB_FUNCTION_TYPE","0","IL","-1"
"845","BONUS_GRADE","0","AC","-1"
"846","BONUS_GRADE","0","AN","-1"
"847","BONUS_GRADE","0","AU","-1"
"848","BONUS_GRADE","0","BN","-1"
"849","BONUS_GRADE","0","BU","-1"
"850","BONUS_GRADE","0","CN","-1"
"851","BONUS_GRADE","0","CU","-1"
"852","BONUS_GRADE","0","DN","-1"
"853","BONUS_GRADE","0","DU","-1"
"854","BONUS_GRADE","0","EN","-1"
"855","BONUS_GRADE","0","EU","-1"
"856","BONUS_GRADE","0","F","-1"
"857","BONUS_GRADE","0","FN","-1"
"858","BONUS_GRADE","0","FU","-1"
"859","BONUS_GRADE","0","NA","-1"
"867","regular-temp","0","PERM","-1"
"868","regular-temp","0","NONPERM","-1"
"869","REGION_SGP","0","1","-1"
"870","REGION_SGP","0","2","-1"
"871","REGION_SGP","0","3","-1"
"872","REGION_SGP","0","4","-1"
"873","REGION_SGP","0","5","-1"
"874","VISATYPE_USA","0","A-1","-1"
"875","VISATYPE_USA","0","A-2","-1"
"876","VISATYPE_USA","0","A-3","-1"
"877","VISATYPE_USA","0","B-1","-1"
"878","VISATYPE_USA","0","B-2","-1"
"879","VISATYPE_USA","0","C-1","-1"
"880","VISATYPE_USA","0","C-2","-1"
"881","VISATYPE_USA","0","C-3","-1"
"882","VISATYPE_USA","0","CP","-1"
"883","VISATYPE_USA","0","DV-1","-1"
"884","VISATYPE_USA","0","DV-2","-1"
"885","VISATYPE_USA","0","E-1","-1"
"886","VISATYPE_USA","0","E-2","-1"
"887","VISATYPE_USA","0","E-3","-1"
"888","VISATYPE_USA","0","EB-5","-1"
"889","VISATYPE_USA","0","F-1","-1"
"890","VISATYPE_USA","0","F-2","-1"
"891","VISATYPE_USA","0","F-3","-1"
"892","VISATYPE_USA","0","G-1","-1"
"893","VISATYPE_USA","0","G-2","-1"
"894","VISATYPE_USA","0","G-3","-1"
"895","VISATYPE_USA","0","G-4","-1"
"896","VISATYPE_USA","0","G-5","-1"
"897","VISATYPE_USA","0","GB","-1"
"898","VISATYPE_USA","0","GT","-1"
"899","VISATYPE_USA","0","H-1B","-1"
"900","VISATYPE_USA","0","H-1B1","-1"
"901","VISATYPE_USA","0","H-1C","-1"
"902","VISATYPE_USA","0","H-2A","-1"
"903","VISATYPE_USA","0","H-3","-1"
"904","VISATYPE_USA","0","H-4","-1"
"905","VISATYPE_USA","0","I-1","-1"
"906","VISATYPE_USA","0","IH-3","-1"
"907","VISATYPE_USA","0","IH-4","-1"
"908","VISATYPE_USA","0","IR-1","-1"
"909","VISATYPE_USA","0","IR-2","-1"
"910","VISATYPE_USA","0","CR-2","-1"
"911","VISATYPE_USA","0","IR-3","-1"
"912","VISATYPE_USA","0","IR-4","-1"
"913","VISATYPE_USA","0","IR-5","-1"
"914","VISATYPE_USA","0","J-1","-1"
"915","VISATYPE_USA","0","J-2","-1"
"916","VISATYPE_USA","0","K-1","-1"
"917","VISATYPE_USA","0","K-2","-1"
"918","VISATYPE_USA","0","K-3","-1"
"919","VISATYPE_USA","0","K-4","-1"
"920","VISATYPE_USA","0","L-1","-1"
"921","VISATYPE_USA","0","L-2","-1"
"922","VISATYPE_USA","0","M-1","-1"
"923","VISATYPE_USA","0","M-2","-1"
"924","VISATYPE_USA","0","N-1","-1"
"925","VISATYPE_USA","0","N-2","-1"
"926","VISATYPE_USA","0","N-3","-1"
"927","VISATYPE_USA","0","N-4","-1"
"928","VISATYPE_USA","0","N-5","-1"
"929","VISATYPE_USA","0","N-6","-1"
"930","VISATYPE_USA","0","N-8","-1"
"931","VISATYPE_USA","0","N-9","-1"
"932","VISATYPE_USA","0","O-1","-1"
"933","VISATYPE_USA","0","O-2","-1"
"934","VISATYPE_USA","0","O-3","-1"
"935","VISATYPE_USA","0","P-1","-1"
"936","VISATYPE_USA","0","P-2","-1"
"937","VISATYPE_USA","0","P-3","-1"
"938","VISATYPE_USA","0","P-4","-1"
"939","VISATYPE_USA","0","Q-1","-1"
"940","VISATYPE_USA","0","R-1","-1"
"941","VISATYPE_USA","0","R-2","-1"
"942","VISATYPE_USA","0","S-5","-1"
"943","VISATYPE_USA","0","S-6","-1"
"944","VISATYPE_USA","0","SIJS","-1"
"945","VISATYPE_USA","0","T-1","-1"
"946","VISATYPE_USA","0","T-2","-1"
"947","VISATYPE_USA","0","T-3","-1"
"948","VISATYPE_USA","0","T-4","-1"
"949","VISATYPE_USA","0","TD","-1"
"950","VISATYPE_USA","0","TN","-1"
"951","VISATYPE_USA","0","U-1","-1"
"952","VISATYPE_USA","0","U-2","-1"
"953","VISATYPE_USA","0","U-3","-1"
"954","VISATYPE_USA","0","U-4","-1"
"955","VISATYPE_USA","0","V-2","-1"
"956","VISATYPE_USA","0","V-3","-1"
"957","VISATYPE_USA","0","WB","-1"
"958","VISATYPE_USA","0","WT","-1"
"959","VISATYPE_USA","0","N/A","-1"
"963","employee-type","0","E","-1"
"964","employee-type","0","H","-1"
"965","employee-type","0","N","-1"
"966","employee-type","0","S","-1"
"967","event","0","1","-1"
"968","event","0","2","-1"
"969","event","0","3","-1"
"970","event","0","16","-1"
"971","event","0","15","-1"
"972","event","0","5","-1"
"973","event","0","4","-1"
"974","event","0","11","-1"
"975","event","0","H","-1"
"976","event","0","9","-1"
"977","event","0","10","-1"
"978","event","0","12","-1"
"979","event","0","13","-1"
"980","event","0","14","-1"
"981","event","0","8","-1"
"982","event","0","R","-1"
"983","event","0","22","-1"
"984","event","0","23","-1"
"985","event","0","7","-1"
"986","event","0","26","-1"
"987","event","0","6","-1"
"988","event","0","GA","-1"
"989","event","0","EGA","-1"
"990","event","0","OGA","-1"
"991","event","0","SPP","-1"
"992","event","0","OPP","-1"
"993","event","0","EPP","-1"
"994","PLATFORM","0","US","-1"
"995","PLATFORM","0","UK","-1"
"996","PLATFORM","0","BMU","-1"
"997","COUNTY_GBR","0","BKM","-1"
"998","COUNTY_GBR","0","CAM","-1"
"999","COUNTY_GBR","0","CMA","-1"
"1000","COUNTY_GBR","0","DBY","-1"
"1001","COUNTY_GBR","0","DEV","-1"
"1002","COUNTY_GBR","0","DOR","-1"
"1003","COUNTY_GBR","0","ESX","-1"
"1004","COUNTY_GBR","0","ESS","-1"
"1005","COUNTY_GBR","0","GLS","-1"
"1006","COUNTY_GBR","0","HAM","-1"
"1007","COUNTY_GBR","0","HRT","-1"
"1008","COUNTY_GBR","0","KEN","-1"
"1009","COUNTY_GBR","0","LAN","-1"
"1010","COUNTY_GBR","0","LEC","-1"
"1011","COUNTY_GBR","0","LIN","-1"
"1012","COUNTY_GBR","0","NFK","-1"
"1013","COUNTY_GBR","0","NYK","-1"
"1014","COUNTY_GBR","0","NTH","-1"
"1015","COUNTY_GBR","0","NTT","-1"
"1016","COUNTY_GBR","0","OXF","-1"
"1017","COUNTY_GBR","0","SOM","-1"
"1018","COUNTY_GBR","0","STS","-1"
"1019","COUNTY_GBR","0","SFK","-1"
"1020","COUNTY_GBR","0","SRY","-1"
"1021","COUNTY_GBR","0","WAR","-1"
"1022","COUNTY_GBR","0","WSX","-1"
"1023","COUNTY_GBR","0","WOR","-1"
"1024","COUNTY_GBR","0","BDG","-1"
"1025","COUNTY_GBR","0","BNE","-1"
"1026","COUNTY_GBR","0","BEX","-1"
"1027","COUNTY_GBR","0","BEN","-1"
"1028","COUNTY_GBR","0","BRY","-1"
"1029","COUNTY_GBR","0","CMD","-1"
"1030","COUNTY_GBR","0","CRY","-1"
"1031","COUNTY_GBR","0","EAL","-1"
"1032","COUNTY_GBR","0","ENF","-1"
"1033","COUNTY_GBR","0","GRE","-1"
"1034","COUNTY_GBR","0","HCK","-1"
"1035","COUNTY_GBR","0","HMF","-1"
"1036","COUNTY_GBR","0","HRY","-1"
"1037","COUNTY_GBR","0","HRW","-1"
"1038","COUNTY_GBR","0","HAV","-1"
"1039","COUNTY_GBR","0","HIL","-1"
"1040","COUNTY_GBR","0","HNS","-1"
"1041","COUNTY_GBR","0","ISL","-1"
"1042","COUNTY_GBR","0","KEC","-1"
"1043","COUNTY_GBR","0","KTT","-1"
"1044","COUNTY_GBR","0","LBH","-1"
"1045","COUNTY_GBR","0","LEW","-1"
"1046","COUNTY_GBR","0","MRT","-1"
"1047","COUNTY_GBR","0","NWM","-1"
"1048","COUNTY_GBR","0","RDB","-1"
"1049","COUNTY_GBR","0","RIC","-1"
"1050","COUNTY_GBR","0","SWK","-1"
"1051","COUNTY_GBR","0","STN","-1"
"1052","COUNTY_GBR","0","TWH","-1"
"1053","COUNTY_GBR","0","WFT","-1"
"1054","COUNTY_GBR","0","WND","-1"
"1055","COUNTY_GBR","0","WSM","-1"
"1056","COUNTY_GBR","0","BNS","-1"
"1057","COUNTY_GBR","0","BIR","-1"
"1058","COUNTY_GBR","0","BOL","-1"
"1059","COUNTY_GBR","0","BRD","-1"
"1060","COUNTY_GBR","0","BUR","-1"
"1061","COUNTY_GBR","0","CLD","-1"
"1062","COUNTY_GBR","0","COV","-1"
"1063","COUNTY_GBR","0","DNC","-1"
"1064","COUNTY_GBR","0","DUD","-1"
"1065","COUNTY_GBR","0","GAT","-1"
"1066","COUNTY_GBR","0","KIR","-1"
"1067","COUNTY_GBR","0","KWL","-1"
"1068","COUNTY_GBR","0","LDS","-1"
"1069","COUNTY_GBR","0","LIV","-1"
"1070","COUNTY_GBR","0","MAN","-1"
"1071","COUNTY_GBR","0","NET","-1"
"1072","COUNTY_GBR","0","NTY","-1"
"1073","COUNTY_GBR","0","OLD","-1"
"1074","COUNTY_GBR","0","RCH","-1"
"1075","COUNTY_GBR","0","ROT","-1"
"1076","COUNTY_GBR","0","SHN","-1"
"1077","COUNTY_GBR","0","SLF","-1"
"1078","COUNTY_GBR","0","SAW","-1"
"1079","COUNTY_GBR","0","SFT","-1"
"1080","COUNTY_GBR","0","SHF","-1"
"1081","COUNTY_GBR","0","SOL","-1"
"1082","COUNTY_GBR","0","STY","-1"
"1083","COUNTY_GBR","0","SKP","-1"
"1084","COUNTY_GBR","0","SND","-1"
"1085","COUNTY_GBR","0","TAM","-1"
"1086","COUNTY_GBR","0","TRF","-1"
"1087","COUNTY_GBR","0","WKF","-1"
"1088","COUNTY_GBR","0","WLL","-1"
"1089","COUNTY_GBR","0","WGN","-1"
"1090","COUNTY_GBR","0","WRL","-1"
"1091","COUNTY_GBR","0","WLV","-1"
"1092","COUNTY_GBR","0","BAS","-1"
"1093","COUNTY_GBR","0","BBD","-1"
"1094","COUNTY_GBR","0","BDF","-1"
"1095","COUNTY_GBR","0","BPL","-1"
"1096","COUNTY_GBR","0","BMH","-1"
"1097","COUNTY_GBR","0","BRC","-1"
"1098","COUNTY_GBR","0","BNH","-1"
"1099","COUNTY_GBR","0","BST","-1"
"1100","COUNTY_GBR","0","CBF","-1"
"1101","COUNTY_GBR","0","CHE","-1"
"1102","COUNTY_GBR","0","CHW","-1"
"1103","COUNTY_GBR","0","CON","-1"
"1104","COUNTY_GBR","0","DAL","-1"
"1105","COUNTY_GBR","0","DER","-1"
"1106","COUNTY_GBR","0","DUR","-1"
"1107","COUNTY_GBR","0","ERY","-1"
"1108","COUNTY_GBR","0","HAL","-1"
"1109","COUNTY_GBR","0","HPL","-1"
"1110","COUNTY_GBR","0","HEF","-1"
"1111","COUNTY_GBR","0","IOW","-1"
"1112","COUNTY_GBR","0","KHL","-1"
"1113","COUNTY_GBR","0","LCE","-1"
"1114","COUNTY_GBR","0","LUT","-1"
"1115","COUNTY_GBR","0","MDW","-1"
"1116","COUNTY_GBR","0","MDB","-1"
"1117","COUNTY_GBR","0","MIK","-1"
"1118","COUNTY_GBR","0","NEL","-1"
"1119","COUNTY_GBR","0","NLN","-1"
"1120","COUNTY_GBR","0","NSM","-1"
"1121","COUNTY_GBR","0","NBL","-1"
"1122","COUNTY_GBR","0","NGM","-1"
"1123","COUNTY_GBR","0","PTE","-1"
"1124","COUNTY_GBR","0","PLY","-1"
"1125","COUNTY_GBR","0","POL","-1"
"1126","COUNTY_GBR","0","POR","-1"
"1127","COUNTY_GBR","0","RDG","-1"
"1128","COUNTY_GBR","0","RCC","-1"
"1129","COUNTY_GBR","0","RUT","-1"
"1130","COUNTY_GBR","0","SHR","-1"
"1131","COUNTY_GBR","0","SLG","-1"
"1132","COUNTY_GBR","0","SGC","-1"
"1133","COUNTY_GBR","0","STH","-1"
"1134","COUNTY_GBR","0","SOS","-1"
"1135","COUNTY_GBR","0","STT","-1"
"1136","COUNTY_GBR","0","STE","-1"
"1137","COUNTY_GBR","0","SWD","-1"
"1138","COUNTY_GBR","0","TFW","-1"
"1139","COUNTY_GBR","0","THR","-1"
"1140","COUNTY_GBR","0","TOB","-1"
"1141","COUNTY_GBR","0","WRT","-1"
"1142","COUNTY_GBR","0","WBK","-1"
"1143","COUNTY_GBR","0","WIL","-1"
"1144","COUNTY_GBR","0","WNM","-1"
"1145","COUNTY_GBR","0","WOK","-1"
"1146","COUNTY_GBR","0","YOR","-1"
"1147","COUNTY_GBR","0","LND","-1"
"1148","COUNTY_GBR","0","ANT","-1"
"1149","COUNTY_GBR","0","ARD","-1"
"1150","COUNTY_GBR","0","ARM","-1"
"1151","COUNTY_GBR","0","BLA","-1"
"1152","COUNTY_GBR","0","BLY","-1"
"1153","COUNTY_GBR","0","BNB","-1"
"1154","COUNTY_GBR","0","BFS","-1"
"1155","COUNTY_GBR","0","CKF","-1"
"1156","COUNTY_GBR","0","CSR","-1"
"1157","COUNTY_GBR","0","CLR","-1"
"1158","COUNTY_GBR","0","CKT","-1"
"1159","COUNTY_GBR","0","CGV","-1"
"1160","COUNTY_GBR","0","DRY","-1"
"1161","COUNTY_GBR","0","DOW","-1"
"1162","COUNTY_GBR","0","DGN","-1"
"1163","COUNTY_GBR","0","FER","-1"
"1164","COUNTY_GBR","0","LRN","-1"
"1165","COUNTY_GBR","0","LMV","-1"
"1166","COUNTY_GBR","0","LSB","-1"
"1167","COUNTY_GBR","0","MFT","-1"
"1168","COUNTY_GBR","0","MYL","-1"
"1169","COUNTY_GBR","0","NYM","-1"
"1170","COUNTY_GBR","0","NTA","-1"
"1171","COUNTY_GBR","0","NDN","-1"
"1172","COUNTY_GBR","0","OMH","-1"
"1173","COUNTY_GBR","0","STB","-1"
"1174","COUNTY_GBR","0","ABE","-1"
"1175","COUNTY_GBR","0","ABD","-1"
"1176","COUNTY_GBR","0","ANS","-1"
"1177","COUNTY_GBR","0","AGB","-1"
"1178","COUNTY_GBR","0","CLK","-1"
"1179","COUNTY_GBR","0","DGY","-1"
"1180","COUNTY_GBR","0","DND","-1"
"1181","COUNTY_GBR","0","EAY","-1"
"1182","COUNTY_GBR","0","EDU","-1"
"1183","COUNTY_GBR","0","ELN","-1"
"1184","COUNTY_GBR","0","ERW","-1"
"1185","COUNTY_GBR","0","EDH","-1"
"1186","COUNTY_GBR","0","ELS","-1"
"1187","COUNTY_GBR","0","FAL","-1"
"1188","COUNTY_GBR","0","FIF","-1"
"1189","COUNTY_GBR","0","GLG","-1"
"1190","COUNTY_GBR","0","HLD","-1"
"1191","COUNTY_GBR","0","IVC","-1"
"1192","COUNTY_GBR","0","MLN","-1"
"1193","COUNTY_GBR","0","MRY","-1"
"1194","COUNTY_GBR","0","NAY","-1"
"1195","COUNTY_GBR","0","NLK","-1"
"1196","COUNTY_GBR","0","ORK","-1"
"1197","COUNTY_GBR","0","PKN","-1"
"1198","COUNTY_GBR","0","RFW","-1"
"1199","COUNTY_GBR","0","SCB","-1"
"1200","COUNTY_GBR","0","ZET","-1"
"1201","COUNTY_GBR","0","SAY","-1"
"1202","COUNTY_GBR","0","SLK","-1"
"1203","COUNTY_GBR","0","STG","-1"
"1204","COUNTY_GBR","0","WDU","-1"
"1205","COUNTY_GBR","0","WLN","-1"
"1206","COUNTY_GBR","0","BGW","-1"
"1207","COUNTY_GBR","0","BGE","-1"
"1208","COUNTY_GBR","0","CAY","-1"
"1209","COUNTY_GBR","0","CRF","-1"
"1210","COUNTY_GBR","0","CMN","-1"
"1211","COUNTY_GBR","0","CGN","-1"
"1212","COUNTY_GBR","0","CWY","-1"
"1213","COUNTY_GBR","0","DEN","-1"
"1214","COUNTY_GBR","0","FLN","-1"
"1215","COUNTY_GBR","0","GWN","-1"
"1216","COUNTY_GBR","0","AGY","-1"
"1217","COUNTY_GBR","0","MTY","-1"
"1218","COUNTY_GBR","0","MON","-1"
"1219","COUNTY_GBR","0","NTL","-1"
"1220","COUNTY_GBR","0","NWP","-1"
"1221","COUNTY_GBR","0","PEM","-1"
"1222","COUNTY_GBR","0","POW","-1"
"1223","COUNTY_GBR","0","RCT","-1"
"1224","COUNTY_GBR","0","SWA","-1"
"1225","COUNTY_GBR","0","TOF","-1"
"1226","COUNTY_GBR","0","VGL","-1"
"1227","COUNTY_GBR","0","WRX","-1"
"1228","COUNTY_GBR","0","AV","-1"
"1229","COUNTY_GBR","0","AYR","-1"
"1230","COUNTY_GBR","0","GLN","-1"
"1231","COUNTY_GBR","0","CHS","-1"
"1232","COUNTY_GBR","0","CLW","-1"
"1233","COUNTY_GBR","0","INV","-1"
"1234","COUNTY_GBR","0","SYO","-1"
"1235","COUNTY_GBR","0","SUS","-1"
"1236","COUNTY_GBR","0","WMI","-1"
"1237","COUNTY_GBR","0","MAN","-1"
"1238","BankName","0","1stColonialNationalBank","-1"
"1239","BankName","0","CooperativeBankplc","-1"
"1240","BankName","0","BanqueAlternativeSuisse","-1"
"1241","BankName","0","BankofAmerica","-1"
"1242","BankName","0","BankofBermuda","-1"
"1243","BankName","0","BankofScotland","-1"
"1244","BankName","0","Barclays","-1"
"1245","BankName","0","ButterfieldBank","-1"
"1246","BankName","0","CHoare&Co","-1"
"1247","BankName","0","Sovereign","-1"
"1248","BankName","0","Citibank","-1"
"1249","BankName","0","LCL","-1"
"1250","BankName","0","CityofBostonCreditUnion","-1"
"1251","BankName","0","UlsterBank","-1"
"1252","BankName","0","CommerceBank,NA","-1"
"1253","BankName","0","CooperativeBankplc","-1"
"1254","BankName","0","Coutts&Co","-1"
"1255","BankName","0","EasternBank","-1"
"1256","BankName","0","FirstDirect","-1"
"1257","BankName","0","Halifax","-1"
"1258","BankName","0","HBOS","-1"
"1259","BankName","0","HSBC","-1"
"1260","BankName","0","HSBCInternational","-1"
"1261","BankName","0","Comdirect","-1"
"1262","BankName","0","RaiffeisenBank","-1"
"1263","BankName","0","LloydsTSB","-1"
"1264","BankName","0","BaslerKantonalbank","-1"
"1265","BankName","0","BanqueAlternativeSuisse","-1"
"1266","BankName","0","IntelligentFinance","-1"
"1267","BankName","0","Nationwide","-1"
"1268","BankName","0","TSB","-1"
"1269","BankName","0","Natwest","-1"
"1270","BankName","0","LloydsBank","-1"
"1271","BankName","0","NewAllianceBank","-1"
"1272","BankName","0","NutmegStateFederalCreditUnion","-1"
"1273","BankName","0","FirstTrustBank","-1"
"1274","BankName","0","RBOS","-1"
"1275","BankName","0","Regions","-1"
"1276","BankName","0","Smile","-1"
"1277","BankName","0","StrataBank","-1"
"1278","BankName","0","TDBanknorth","-1"
"1279","BankName","0","TheCooperativeBank","-1"
"1280","BankName","0","TheOneAccount","-1"
"1281","BankName","0","VirginOne","-1"
"1282","BankName","0","Wachovia","-1"
"1283","BankName","0","WebsterBank","-1"
"1284","BankName","0","WellsFargo","-1"
"1285","BankName","0","WestboroughBank","-1"
"1286","BankName","0","HuntingtonNationalBank","-1"
"1287","BankName","0","BrooklineCooperative","-1"
"1288","BankName","0","SunTrustBank","-1"
"1289","BankName","0","KennebunkSavings","-1"
"1290","BankName","0","DigitalFederalCreditUnion","-1"
"1291","BankName","0","HarvardCreditUnion","-1"
"1292","BankName","0","BankOne,NA","-1"
"1293","BankName","0","FirstCreditUnion","-1"
"1294","BankName","0","FirstNationalBankofSuffield","-1"
"1295","BankName","0","CoventryBuildingSociety","-1"
"1296","BankName","0","WashingtonMutualBank","-1"
"1297","BankName","0","NavyFederalCreditUnion","-1"
"1298","BankName","0","BethpageFederalCreditUnion","-1"
"1299","BankName","0","ZuercherKantonalbank","-1"
"1300","BankName","0","BankofIreland","-1"
"1301","BankName","0","BankofButerfield","-1"
"1302","BankName","0","AlliedIrish","-1"
"1303","BankName","0","DanversBank","-1"
"1304","BankName","0","UBS","-1"
"1305","BankName","0","UBSAGZurich","-1"
"1306","BankName","0","CreditAgricole","-1"
"1307","BankName","0","ZuercherKantonalbankCH-8010","-1"
"1308","BankName","0","UNITEDOVERSEASBANKLIMITED","-1"
"1309","BankName","0","HSBCSingapore","-1"
"1310","BankName","0","CreditSuisse","-1"
"1311","BankName","0","NewHorizons","-1"
"1312","BankName","0","AssociatedCreditUnion","-1"
"1313","BankName","0","SocieteGenerale","-1"
"1314","BankName","0","POSB","-1"
"1315","BankName","0","RBS","-1"
"1316","BankName","0","SchwyzerKantonalBank","-1"
"1317","BankName","0","BNPParibas","-1"
"1318","BankName","0","PermanentTSB","-1"
"1319","BankName","0","Baloise","-1"
"1320","BankName","0","Clydesdale","-1"
"1321","BankName","0","Citizens","-1"
"1322","BankName","0","PeoplesBank","-1"
"1323","BankName","0","StJamesPlaceBank","-1"
"1324","BankName","0","Century","-1"
"1325","BankName","0","TheRoyalBankofScotland","-1"
"1326","BankName","0","BarclaysPremier","-1"
"1327","BankName","0","ING-Diba","-1"
"1328","BankName","0","Sparda-BankWest","-1"
"1329","BankName","0","Santander","-1"
"1330","BankName","0","Norwich&PeterboroughBuildingSociety","-1"
"1331","BankName","0","AargavischeKantonalbank","-1"
"1332","BankName","0","AargauischeKantonalbank","-1"
"1333","BankName","0","UnitedOverseasBankSingapore","-1"
"1334","BankName","0","ZKBPrivatkonto","-1"
"1335","BankName","0","PostFinance","-1"
"1336","BankName","0","NationalIrishBank","-1"
"1337","BankName","0","Targobank","-1"
"1338","BankName","0","CountryBankSavings","-1"
"1339","BankName","0","Sarda-BankWest","-1"
"1340","BankName","0","ZugerKantonalbank","-1"
"1341","BankName","0","BarclaysWealth","-1"
"1342","BankName","0","Nedbank","-1"
"1343","BankName","0","BridgewaterCreditUnion","-1"
"1344","BankName","0","Abbey","-1"
"1345","BankName","0","UBSZurich","-1"
"1346","BankName","0","PostOfficeSavingsBank","-1"
"1347","BankName","0","MigrosBankZurich","-1"
"1348","BankName","0","UBSAG","-1"
"1349","BankName","0","Swiss Post -Post Finance","-1"
"1350","BankName","0","SebBankMunchen","-1"
"1351","BankName","0","BankNorthMassachusetts","-1"
"1352","BankName","0","ZKBWinterthur","-1"
"1353","BankName","0","FarmersStateBank","-1"
"1354","BankName","0","DBS","-1"
"1355","BankName","0","AlternativeBankSchweizAG","-1"
"1356","BankName","0","Yorkshire","-1"
"1357","BankName","0","PostKontoBank","-1"
"1358","BankName","0","ZuercherKantonalbank","-1"
"1359","BankName","0","HSBCFrance","-1"
"1360","BankName","0","Cahoot","-1"
"1361","BankName","0","Westpac","-1"
"1362","BankName","0","Unassigned","-1"
"1363","ETHNICGROUP_GBR","0","WHBR","-1"
"1364","ETHNICGROUP_GBR","0","WHIR","-1"
"1365","ETHNICGROUP_GBR","0","WHIOT","-1"
"1366","ETHNICGROUP_GBR","0","MIXED","-1"
"1367","ETHNICGROUP_GBR","0","INDIAN","-1"
"1368","ETHNICGROUP_GBR","0","PAKIS","-1"
"1369","ETHNICGROUP_GBR","0","BANG","-1"
"1370","ETHNICGROUP_GBR","0","ASIAN","-1"
"1371","ETHNICGROUP_GBR","0","CARIB","-1"
"1372","ETHNICGROUP_GBR","0","AFRIC","-1"
"1373","ETHNICGROUP_GBR","0","CHIN","-1"
"1374","ETHNICGROUP_GBR","0","OTH","-1"
"1375","yesno","0","N","0"
"1376","yesno","0","Y","0"
"1377","relation","0","SPOUSE","-1"
"1378","relation","0","CHILD","-1"
"1379","relation","0","PARENT","-1"
"1380","relation","0","SIBLING","-1"
"1381","relation","0","OTHER","-1"
"1382","relation","0","AUNT","-1"
"1383","relation","0","COUSIN","-1"
"1384","relation","0","INLAW","-1"
"1385","relation","0","NIECE","-1"
"1386","relation","0","NEPHEW","-1"
"1387","relation","0","UNCLE","-1"
"1388","relation","0","GRANDCHILD","-1"
"1389","relation","0","PARTN","-1"
"1390","relation","0","FRIEND","-1"
"1391","SAL_CHG_RSN","0","INC","-1"
"1392","SAL_CHG_RSN","0","MKT_ADJ","-1"
"1393","SAL_CHG_RSN","0","RED_RES","-1"
"1394","SAL_CHG_RSN","0","BON_POT","-1"
"1395","SAL_CHG_RSN","0","SAL_TRA","-1"
"1396","SAL_CHG_RSN","0","SAL_REL","-1"
"1397","SAL_CHG_RSN","0","OTH_REA","-1"
"1398","SAL_CHG_RSN","0","PROM","-1"
"1399","jobRelType","0","HR_MGR","-1"
"1400","jobRelType","0","2ND_MGR","-1"
"1401","jobRelType","0","ADD_MGR","-1"
"1402","jobRelType","0","MTX_MGR","-1"
"1403","jobRelType","0","APP_MGR","-1"
"1404","COUNTY_IRL","0","CO","-1"
"1405","COUNTY_IRL","0","CE","-1"
"1406","COUNTY_IRL","0","CN","-1"
"1407","COUNTY_IRL","0","CW","-1"
"1408","COUNTY_IRL","0","D","-1"
"1409","COUNTY_IRL","0","DL","-1"
"1410","COUNTY_IRL","0","G","-1"
"1411","COUNTY_IRL","0","KE","-1"
"1412","COUNTY_IRL","0","KK","-1"
"1413","COUNTY_IRL","0","KY","-1"
"1414","COUNTY_IRL","0","LD","-1"
"1415","COUNTY_IRL","0","LH","-1"
"1416","COUNTY_IRL","0","LK","-1"
"1417","COUNTY_IRL","0","LM","-1"
"1418","COUNTY_IRL","0","LS","-1"
"1419","COUNTY_IRL","0","MH","-1"
"1420","COUNTY_IRL","0","MN","-1"
"1421","COUNTY_IRL","0","MO","-1"
"1422","COUNTY_IRL","0","OY","-1"
"1423","COUNTY_IRL","0","RN","-1"
"1424","COUNTY_IRL","0","SO","-1"
"1425","COUNTY_IRL","0","TA","-1"
"1426","COUNTY_IRL","0","WD","-1"
"1427","COUNTY_IRL","0","WH","-1"
"1428","COUNTY_IRL","0","WW","-1"
"1429","COUNTY_IRL","0","WX","-1"
"1430","COUNTY_IRL","0","D3","-1"
"1431","COUNTY_IRL","0","D24","-1"
"1432","COUNTY_IRL","0","CWW","-1"
"1433","COUNTY_IRL","0","CD","-1"
"1434","COUNTY_IRL","0","I","-1"
"1435","COUNTY_IRL","0","D9","-1"
"1436","EEO6CODE_USA","0","1","-1"
"1437","EEO6CODE_USA","0","2","-1"
"1438","EEO6CODE_USA","0","3","-1"
"1439","EEO6CODE_USA","0","4","-1"
"1440","EEO6CODE_USA","0","5","-1"
"1441","EEO6CODE_USA","0","6","-1"
"1442","EEO6CODE_USA","0","7","-1"
"1443","EEO6CODE_USA","0","N","-1"
"1444","product_line","0","PROD1","-1"
"1445","product_line","0","PROD2","-1"
"1446","product_line","0","PROD3","-1"
"1447","product_line","0","PROD4","-1"
"1448","product_line","0","PROD5","-1"
"1449","product_line","0","PROD6","-1"
"1450","product_line","0","PROD7","-1"
"1451","product_line","0","PROD8","-1"
"1452","product_line","0","PROD9","-1"
"1453","product_line","0","PROD10","-1"
"1454","product_line","0","PROD11","-1"
"1455","product_line","0","PROD12","-1"
"1456","product_line","0","PROD13","-1"
"1457","product_line","0","PROD14","-1"
"1458","product_line","0","PROD15","-1"
"1459","product_line","0","PROD16","-1"
"1460","product_line","0","PROD17","-1"
"1461","product_line","0","PROD18","-1"
"1462","product_line","0","PROD19","-1"
"1463","product_line","0","PROD20","-1"
"1464","product_line","0","PROD21","-1"
"1465","product_line","0","PROD22","-1"
"1466","product_line","0","PROD23","-1"
"1467","Nationality","0","ALGERIAN","-1"
"1468","Nationality","0","AMER/GBR","-1"
"1469","Nationality","0","AMERICAN","-1"
"1470","Nationality","0","ARGENTINE","-1"
"1471","Nationality","0","AUSSWISS","-1"
"1472","Nationality","0","AUSTRALIAN","-1"
"1473","Nationality","0","AUSTRIAN","-1"
"1474","Nationality","0","BAHRAINI","-1"
"1475","Nationality","0","BANGLDESHI","-1"
"1476","Nationality","0","BELGIAN","-1"
"1477","Nationality","0","BERMUDIAN","-1"
"1478","Nationality","0","BLANK","-1"
"1479","Nationality","0","BRAZILIAN","-1"
"1480","Nationality","0","BRITAMER","-1"
"1481","Nationality","0","BRITAUS","-1"
"1482","Nationality","0","BRITCANAD","-1"
"1483","Nationality","0","BRITISH","-1"
"1484","Nationality","0","BRITNIGERI","-1"
"1485","Nationality","0","BRITSTHAFR","-1"
"1486","Nationality","0","BRUNEIAN","-1"
"1487","Nationality","0","BULGARIAN","-1"
"1488","Nationality","0","CANADIAN","-1"
"1489","Nationality","0","CHINESE","-1"
"1490","Nationality","0","COLOMBIAN","-1"
"1491","Nationality","0","CYPRIOT","-1"
"1492","Nationality","0","DANISH","-1"
"1493","Nationality","0","DECLINED","-1"
"1494","Nationality","0","DUTCH","-1"
"1495","Nationality","0","EGYPTIAN","-1"
"1496","Nationality","0","EMIRATI","-1"
"1497","Nationality","0","ENGFRENCH","-1"
"1498","Nationality","0","ENGLISH","-1"
"1499","Nationality","0","FINNISH","-1"
"1500","Nationality","0","FRENCH","-1"
"1501","Nationality","0","GERMAN","-1"
"1502","Nationality","0","GHANAIAN","-1"
"1503","Nationality","0","GRKCYPRIOT","-1"
"1504","Nationality","0","INDIAN","-1"
"1505","Nationality","0","INDONESIAN","-1"
"1506","Nationality","0","IRISH","-1"
"1507","Nationality","0","IRISHSA","-1"
"1508","Nationality","0","ISRAELI","-1"
"1509","Nationality","0","ITALIAN","-1"
"1510","Nationality","0","JAPANESE","-1"
"1511","Nationality","0","JORDANIAN","-1"
"1512","Nationality","0","KENYAN","-1"
"1513","Nationality","0","KOSOVIAN","-1"
"1514","Nationality","0","KUWAITI","-1"
"1515","Nationality","0","LEBANESE","-1"
"1516","Nationality","0","LITHUANIAN","-1"
"1517","Nationality","0","MALAYSIAN","-1"
"1518","Nationality","0","MAURITIAN","-1"
"1519","Nationality","0","MEXICAN","-1"
"1520","Nationality","0","NEWZEALNDR","-1"
"1521","Nationality","0","NIGERIAN","-1"
"1522","Nationality","0","NOTADVISED","-1"
"1523","Nationality","0","OMANI","-1"
"1524","Nationality","0","PAKISTANI","-1"
"1525","Nationality","0","PALSTINIAN","-1"
"1526","Nationality","0","PHILIPINOS","-1"
"1527","Nationality","0","POLISH","-1"
"1528","Nationality","0","PORTUGESE","-1"
"1529","Nationality","0","QATARI","-1"
"1530","Nationality","0","ROMANIAN","-1"
"1531","Nationality","0","RUSSIAN","-1"
"1532","Nationality","0","SAUDARBIAN","-1"
"1533","Nationality","0","SINGAPREAN","-1"
"1534","Nationality","0","SOMALI","-1"
"1535","Nationality","0","SPANISH","-1"
"1536","Nationality","0","SRILANKAN","-1"
"1537","Nationality","0","STHAFRICAN","-1"
"1538","Nationality","0","SUDANESE","-1"
"1539","Nationality","0","SWEDISH","-1"
"1540","Nationality","0","SWISS","-1"
"1541","Nationality","0","SWISS/CAN","-1"
"1542","Nationality","0","SWISSITAL","-1"
"1543","Nationality","0","SYRIAN","-1"
"1544","Nationality","0","TAIWANESE","-1"
"1545","Nationality","0","TANZANIAN","-1"
"1546","Nationality","0","THAI","-1"
"1547","Nationality","0","VIETNAMESE","-1"
"1548","Nationality","0","YEMENI","-1"
"1549","Nationality","0","ZIMBABWE","-1"
"1550","ECRating","0","1","-1"
"1551","ECRating","0","2","-1"
"1552","ECRating","0","3","-1"
"1553","ECRating","0","4","-1"
"1554","ECRating","0","5","-1"
"1555","BEHAVE_RATING","0","B1","1"
"1556","BEHAVE_RATING","0","B2","1"
"1557","BEHAVE_RATING","0","B3","1"
"1558","BEHAVE_RATING","0","B4","1"
"1559","STATE_USA","0","AL","-1"
"1560","STATE_USA","0","AK","-1"
"1561","STATE_USA","0","AZ","-1"
"1562","STATE_USA","0","AR","-1"
"1563","STATE_USA","0","CA","-1"
"1564","STATE_USA","0","CO","-1"
"1565","STATE_USA","0","CT","-1"
"1566","STATE_USA","0","DE","-1"
"1567","STATE_USA","0","DC","-1"
"1568","STATE_USA","0","FL","-1"
"1569","STATE_USA","0","GA","-1"
"1570","STATE_USA","0","HI","-1"
"1571","STATE_USA","0","ID","-1"
"1572","STATE_USA","0","IL","-1"
"1573","STATE_USA","0","IN","-1"
"1574","STATE_USA","0","IA","-1"
"1575","STATE_USA","0","KS","-1"
"1576","STATE_USA","0","KY","-1"
"1577","STATE_USA","0","LA","-1"
"1578","STATE_USA","0","ME","-1"
"1579","STATE_USA","0","MD","-1"
"1580","STATE_USA","0","MA","-1"
"1581","STATE_USA","0","MI","-1"
"1582","STATE_USA","0","MN","-1"
"1583","STATE_USA","0","MS","-1"
"1584","STATE_USA","0","MO","-1"
"1585","STATE_USA","0","MT","-1"
"1586","STATE_USA","0","NE","-1"
"1587","STATE_USA","0","NV","-1"
"1588","STATE_USA","0","NH","-1"
"1589","STATE_USA","0","NJ","-1"
"1590","STATE_USA","0","NM","-1"
"1591","STATE_USA","0","NY","-1"
"1592","STATE_USA","0","NC","-1"
"1593","STATE_USA","0","ND","-1"
"1594","STATE_USA","0","OH","-1"
"1595","STATE_USA","0","OK","-1"
"1596","STATE_USA","0","OR","-1"
"1597","STATE_USA","0","PA","-1"
"1598","STATE_USA","0","RI","-1"
"1599","STATE_USA","0","SC","-1"
"1600","STATE_USA","0","SD","-1"
"1601","STATE_USA","0","TN","-1"
"1602","STATE_USA","0","TX","-1"
"1603","STATE_USA","0","UT","-1"
"1604","STATE_USA","0","VT","-1"
"1605","STATE_USA","0","VA","-1"
"1606","STATE_USA","0","WA","-1"
"1607","STATE_USA","0","WV","-1"
"1608","STATE_USA","0","WI","-1"
"1609","STATE_USA","0","WY","-1"
"1610","STATE_USA","0","AS","-1"
"1611","STATE_USA","0","FM","-1"
"1612","STATE_USA","0","GU","-1"
"1613","STATE_USA","0","MH","-1"
"1614","STATE_USA","0","MP","-1"
"1615","STATE_USA","0","PR","-1"
"1616","STATE_USA","0","PW","-1"
"1617","STATE_USA","0","VI","-1"
"1618","YesNoPending","0","Y","-1"
"1619","YesNoPending","0","N","-1"
"1620","YesNoPending","0","P","-1"
"1621","en_salutation","0","mr","-1"
"1622","en_salutation","0","mrs","-1"
"1623","en_salutation","0","ms","-1"
"1624","en_salutation","0","Baron","-1"
"1625","en_salutation","0","Baroness","-1"
"1626","en_salutation","0","Dr","-1"
"1627","en_salutation","0","Miss","-1"
"1628","en_salutation","0","Prof","-1"
"1629","en_salutation","0","Reverend","-1"
"1630","en_salutation","0","Sir","-1"
"1631","DEPARTMENT_FRA","0","1","-1"
"1632","DEPARTMENT_FRA","0","2","-1"
"1633","DEPARTMENT_FRA","0","3","-1"
"1634","DEPARTMENT_FRA","0","4","-1"
"1635","DEPARTMENT_FRA","0","5","-1"
"1636","DEPARTMENT_FRA","0","6","-1"
"1637","DEPARTMENT_FRA","0","7","-1"
"1638","DEPARTMENT_FRA","0","8","-1"
"1639","DEPARTMENT_FRA","0","9","-1"
"1640","DEPARTMENT_FRA","0","10","-1"
"1641","DEPARTMENT_FRA","0","11","-1"
"1642","DEPARTMENT_FRA","0","12","-1"
"1643","DEPARTMENT_FRA","0","13","-1"
"1644","DEPARTMENT_FRA","0","14","-1"
"1645","DEPARTMENT_FRA","0","15","-1"
"1646","DEPARTMENT_FRA","0","16","-1"
"1647","DEPARTMENT_FRA","0","17","-1"
"1648","DEPARTMENT_FRA","0","18","-1"
"1649","DEPARTMENT_FRA","0","19","-1"
"1650","DEPARTMENT_FRA","0","2A","-1"
"1651","DEPARTMENT_FRA","0","2B","-1"
"1652","DEPARTMENT_FRA","0","21","-1"
"1653","DEPARTMENT_FRA","0","22","-1"
"1654","DEPARTMENT_FRA","0","23","-1"
"1655","DEPARTMENT_FRA","0","24","-1"
"1656","DEPARTMENT_FRA","0","25","-1"
"1657","DEPARTMENT_FRA","0","26","-1"
"1658","DEPARTMENT_FRA","0","27","-1"
"1659","DEPARTMENT_FRA","0","28","-1"
"1660","DEPARTMENT_FRA","0","29","-1"
"1661","DEPARTMENT_FRA","0","30","-1"
"1662","DEPARTMENT_FRA","0","31","-1"
"1663","DEPARTMENT_FRA","0","32","-1"
"1664","DEPARTMENT_FRA","0","33","-1"
"1665","DEPARTMENT_FRA","0","34","-1"
"1666","DEPARTMENT_FRA","0","35","-1"
"1667","DEPARTMENT_FRA","0","36","-1"
"1668","DEPARTMENT_FRA","0","37","-1"
"1669","DEPARTMENT_FRA","0","38","-1"
"1670","DEPARTMENT_FRA","0","39","-1"
"1671","DEPARTMENT_FRA","0","40","-1"
"1672","DEPARTMENT_FRA","0","41","-1"
"1673","DEPARTMENT_FRA","0","42","-1"
"1674","DEPARTMENT_FRA","0","43","-1"
"1675","DEPARTMENT_FRA","0","44","-1"
"1676","DEPARTMENT_FRA","0","45","-1"
"1677","DEPARTMENT_FRA","0","46","-1"
"1678","DEPARTMENT_FRA","0","47","-1"
"1679","DEPARTMENT_FRA","0","48","-1"
"1680","DEPARTMENT_FRA","0","49","-1"
"1681","DEPARTMENT_FRA","0","50","-1"
"1682","DEPARTMENT_FRA","0","51","-1"
"1683","DEPARTMENT_FRA","0","52","-1"
"1684","DEPARTMENT_FRA","0","53","-1"
"1685","DEPARTMENT_FRA","0","57","-1"
"1686","DEPARTMENT_FRA","0","55","-1"
"1687","DEPARTMENT_FRA","0","56","-1"
"1688","DEPARTMENT_FRA","0","54","-1"
"1689","DEPARTMENT_FRA","0","58","-1"
"1690","DEPARTMENT_FRA","0","59","-1"
"1691","DEPARTMENT_FRA","0","60","-1"
"1692","DEPARTMENT_FRA","0","61","-1"
"1693","DEPARTMENT_FRA","0","62","-1"
"1694","DEPARTMENT_FRA","0","63","-1"
"1695","DEPARTMENT_FRA","0","64","-1"
"1696","DEPARTMENT_FRA","0","65","-1"
"1697","DEPARTMENT_FRA","0","66","-1"
"1698","DEPARTMENT_FRA","0","67","-1"
"1699","DEPARTMENT_FRA","0","68","-1"
"1700","DEPARTMENT_FRA","0","69","-1"
"1701","DEPARTMENT_FRA","0","70","-1"
"1702","DEPARTMENT_FRA","0","71","-1"
"1703","DEPARTMENT_FRA","0","72","-1"
"1704","DEPARTMENT_FRA","0","73","-1"
"1705","DEPARTMENT_FRA","0","74","-1"
"1706","DEPARTMENT_FRA","0","75","-1"
"1707","DEPARTMENT_FRA","0","76","-1"
"1708","DEPARTMENT_FRA","0","77","-1"
"1709","DEPARTMENT_FRA","0","78","-1"
"1710","DEPARTMENT_FRA","0","79","-1"
"1711","DEPARTMENT_FRA","0","80","-1"
"1712","DEPARTMENT_FRA","0","81","-1"
"1713","DEPARTMENT_FRA","0","82","-1"
"1714","DEPARTMENT_FRA","0","83","-1"
"1715","DEPARTMENT_FRA","0","84","-1"
"1716","DEPARTMENT_FRA","0","85","-1"
"1717","DEPARTMENT_FRA","0","86","-1"
"1718","DEPARTMENT_FRA","0","87","-1"
"1719","DEPARTMENT_FRA","0","88","-1"
"1720","DEPARTMENT_FRA","0","89","-1"
"1721","DEPARTMENT_FRA","0","90","-1"
"1722","DEPARTMENT_FRA","0","91","-1"
"1723","DEPARTMENT_FRA","0","92","-1"
"1724","DEPARTMENT_FRA","0","93","-1"
"1725","DEPARTMENT_FRA","0","94","-1"
"1726","DEPARTMENT_FRA","0","95","-1"
"1727","DEPARTMENT_FRA","0","BL","-1"
"1728","DEPARTMENT_FRA","0","CP","-1"
"1729","DEPARTMENT_FRA","0","GF","-1"
"1730","DEPARTMENT_FRA","0","GP","-1"
"1731","DEPARTMENT_FRA","0","MF","-1"
"1732","DEPARTMENT_FRA","0","MQ","-1"
"1733","DEPARTMENT_FRA","0","NC","-1"
"1734","DEPARTMENT_FRA","0","PF","-1"
"1735","DEPARTMENT_FRA","0","PM","-1"
"1736","DEPARTMENT_FRA","0","RE","-1"
"1737","DEPARTMENT_FRA","0","TF","-1"
"1738","DEPARTMENT_FRA","0","WF","-1"
"1739","DEPARTMENT_FRA","0","YT","-1"
"1740","YesNoNA","0","Y","-1"
"1741","YesNoNA","0","N","-1"
"1742","YesNoNA","0","NA","-1"
"1743","language","0","null","0"
"1744","language","0","null","0"
"1745","language","0","null","0"
"1746","language","0","null","0"
"1747","language","0","null","0"
"1748","language","0","null","0"
"1749","language","0","null","0"
"1750","language","0","null","0"
"1751","language","0","null","0"
"1752","language","0","null","0"
"1753","language","0","null","0"
"1754","language","0","null","0"
"1755","language","0","null","0"
"1756","language","0","null","0"
"1757","language","0","null","0"
"1758","language","0","null","0"
"1759","language","0","null","0"
"1760","language","0","null","0"
"1761","language","0","null","0"
"1762","language","0","null","0"
"1763","language","0","null","0"
"1764","language","0","null","0"
"1765","language","0","null","0"
"1766","language","0","null","0"
"1767","language","0","null","0"
"1768","language","0","null","0"
"1769","language","0","null","0"
"1770","language","0","null","0"
"1771","language","0","null","0"
"1772","language","0","null","0"
"1773","language","0","null","0"
"1774","language","0","null","0"
"1775","language","0","null","0"
"1776","language","0","null","0"
"1777","language","0","null","0"
"1778","language","0","null","0"
"1779","language","0","null","0"
"1780","language","0","null","0"
"1781","language","0","null","0"
"1782","language","0","null","0"
"1783","language","0","null","0"
"1784","language","0","null","0"
"1785","language","0","null","0"
"1786","language","0","null","0"
"1787","language","0","null","0"
"1788","language","0","null","0"
"1789","language","0","null","0"
"1790","language","0","null","0"
"1791","language","0","null","0"
"1792","language","0","null","0"
"1793","Performance_Rating","0","EX_ALL","-1"
"1794","Performance_Rating","0","EX_MOST","-1"
"1795","Performance_Rating","0","EX_SOME","-1"
"1796","Performance_Rating","0","MET_ALL","-1"
"1797","Performance_Rating","0","MET_MOST","-1"
"1798","Performance_Rating","0","DEV_NEED","-1"
"1799","Performance_Rating","0","NOT_MET","-1"
"1800","Performance_Rating","0","TOO_NEW","-1"
"1806","MARITAL_STATUS","0","BLANK","-1"
"1807","MARITAL_STATUS","0","CIVIL","-1"
"1808","MARITAL_STATUS","0","COHABIT","-1"
"1809","MARITAL_STATUS","0","DIVORCE","-1"
"1810","MARITAL_STATUS","0","ENGAGED","-1"
"1811","MARITAL_STATUS","0","MARRIED","-1"
"1812","MARITAL_STATUS","0","NOTADVISED","-1"
"1813","MARITAL_STATUS","0","PARTNER","-1"
"1814","MARITAL_STATUS","0","SEPARATED","-1"
"1815","MARITAL_STATUS","0","SINGLE","-1"
"1816","MARITAL_STATUS","0","WIDOW","-1"
"1817","MARITAL_STATUS","0","DOMPART","-1"
"1818","MARITAL_STATUS","0","LEGSEP","-1"
"1819","TAXTREATMENT","0","R","-1"
"1820","TAXTREATMENT","0","N","-1"
"1821","TAXTREATMENT","0","G","-1"
"1822","personRelationshipType","0","2","-1"
"1823","personRelationshipType","0","6","-1"
"1824","personRelationshipType","0","14","-1"
"1825","personRelationshipType","0","1","-1"
"1826","personRelationshipType","0","17","-1"
"1827","personRelationshipType","0","10","-1"
"1828","personRelationshipType","0","11","-1"
"1829","personRelationshipType","0","12","-1"
"1830","personRelationshipType","0","15","-1"
"1831","personRelationshipType","0","16","-1"
"1832","personRelationshipType","0","8","-1"
"1833","personRelationshipType","0","13","-1"
"1834","PROB_NOTICE","0","PROB1","-1"
"1835","PROB_NOTICE","0","PROB2","-1"
"1836","PROB_NOTICE","0","PROB3","-1"
"1837","PROB_NOTICE","0","PROB4","-1"
"1838","Role_Type","0","1","-1"
"1839","Role_Type","0","2","-1"
"1840","ProductCateg","0","R1","-1"
"1841","ProductCateg","0","R2","-1"
"1842","ProductCateg","0","R3","-1"
"1843","ProductCateg","0","R4","-1"
"1844","ProductCateg","0","R5","-1"
"1845","ProductCateg","0","R6","-1"
"1846","ProductCateg","0","R7","-1"
"1847","ProductCateg","0","R8","-1"
"1848","ProductCateg","0","R9","-1"
"1849","ProductCateg","0","R10","-1"
"1850","ProductCateg","0","R11","-1"
"1851","ProductCateg","0","R12","-1"
"1852","ProductCateg","0","R13","-1"
"1853","ProductCateg","0","R14","-1"
"1854","ProductCateg","0","R15","-1"
"1855","ProductCateg","0","R16","-1"
"1856","ProductCateg","0","R17","-1"
"1857","ProductCateg","0","R18","-1"
"1858","ProductCateg","0","R19","-1"
"1859","ProductCateg","0","R20","-1"
"1860","ProductCateg","0","R21","-1"
"1861","ProductCateg","0","R22","-1"
"1862","ProductCateg","0","R23","-1"
"1863","ProductCateg","0","R24","-1"
"1864","ProductCateg","0","R25","-1"
"1865","ProductCateg","0","R26","-1"
"1866","ProductCateg","0","R27","-1"
"1867","ProductCateg","0","R28","-1"
"1868","ProductCateg","0","R29","-1"
"1869","ProductCateg","0","R30","-1"
"1870","ProductCateg","0","R31","-1"
"1871","ProductCateg","0","R32","-1"
"1872","ProductCateg","0","R33","-1"
"1873","ProductCateg","0","R34","-1"
"1874","ProductCateg","0","R35","-1"
"1875","ProductCateg","0","R36","-1"
"1876","ProductCateg","0","R37","-1"
"1877","ProductCateg","0","R38","-1"
"1878","ProductCateg","0","R39","-1"
"1879","ProductCateg","0","R40","-1"
"1880","ProductCateg","0","R41","-1"
"1881","ProductCateg","0","R42","-1"
"1882","ProductCateg","0","R43","-1"
"1883","ProductCateg","0","R44","-1"
"1884","ProductCateg","0","R45","-1"
"1885","ProductCateg","0","R46","-1"
"1886","ProductCateg","0","R47","-1"
"1887","ProductCateg","0","R48","-1"
"1888","ProductCateg","0","R49","-1"
"1889","ProductCateg","0","R50","-1"
"1890","ProductCateg","0","R51","-1"
"1891","ProductCateg","0","R52","-1"
"1892","ProductCateg","0","R53","-1"
"1893","ProductCateg","0","R54","-1"
"1894","ProductCateg","0","R55","-1"
"1895","ProductCateg","0","R56","-1"
"1896","ProductCateg","0","R57","-1"
"1897","ProductCateg","0","R58","-1"
"1898","ProductCateg","0","R59","-1"
"1899","ProductCateg","0","R60","-1"
"1900","ProductCateg","0","R61","-1"
"1901","ProductCateg","0","R62","-1"
"1902","ProductCateg","0","R63","-1"
"1903","ProductCateg","0","R64","-1"
"1904","EN_EEOJOBG__USA","0","EEO1","1"
"1905","EN_EEOJOBG__USA","0","EEO2","1"
"1906","EN_EEOJOBG__USA","0","EEO3","1"
"1907","EN_EEOJOBG__USA","0","EEO4","1"
"1908","EN_EEOJOBG__USA","0","EEO5","1"
"1909","EN_EEOJOBG__USA","0","EEO6","1"
"1910","EN_EEOJOBG__USA","0","EEO7","1"
"1911","EN_EEOJOBG__USA","0","EEO8","1"
"1912","EN_EEOJOBG__USA","0","EEO9","1"
"1913","EN_EEOJOBG__USA","0","EEO10","1"
"1914","global_assignment_type","0","ST","-1"
"1915","global_assignment_type","0","LT","-1"
"1916","global_assignment_type","0","TR","-1"
"1917","global_assignment_type","0","1W","-1"
"1918","global_assignment_type","0","1Y","-1"
"1919","global_assignment_type","0","2Y","-1"
"1920","global_assignment_type","0","3Y","-1"
"1921","global_assignment_type","0","3M","-1"
"1922","global_assignment_type","0","6M","-1"
"1923","ecEmailType","0","P","-1"
"1924","ecEmailType","0","O","-1"
"1925","ecEmailType","0","B","-1"
"1926","bonusLevel","0","1","-1"
"1927","bonusLevel","0","2","-1"
"1928","bonusLevel","0","3","-1"
"1929","bonusLevel","0","4","-1"
"1930","PayFrequency","0","BW","-1"
"1931","PayFrequency","0","WK","-1"
"1932","PayFrequency","0","SM","-1"
"1933","PayFrequency","0","M","-1"
"1934","NOTICE_PERIOD","0","1wk","-1"
"1935","NOTICE_PERIOD","0","2wk","-1"
"1936","NOTICE_PERIOD","0","1mth","-1"
"1937","NOTICE_PERIOD","0","3mth","-1"
"1938","NOTICE_PERIOD","0","6mth","-1"
"1939","NOTICE_PERIOD","0","12mth","-1"
"1940","NOTICE_PERIOD","0","24mth","-1"
"1941","NOTICE_PERIOD","0","2mth","-1"
"1942","EEO5CODE_USA","0","1","-1"
"1943","EEO5CODE_USA","0","10","-1"
"1944","EEO5CODE_USA","0","11","-1"
"1945","EEO5CODE_USA","0","12","-1"
"1946","EEO5CODE_USA","0","13","-1"
"1947","EEO5CODE_USA","0","14","-1"
"1948","EEO5CODE_USA","0","15","-1"
"1949","EEO5CODE_USA","0","16","-1"
"1950","EEO5CODE_USA","0","17","-1"
"1951","EEO5CODE_USA","0","18","-1"
"1952","EEO5CODE_USA","0","2","-1"
"1953","EEO5CODE_USA","0","3","-1"
"1954","EEO5CODE_USA","0","4","-1"
"1955","EEO5CODE_USA","0","5","-1"
"1956","EEO5CODE_USA","0","6","-1"
"1957","EEO5CODE_USA","0","7","-1"
"1958","EEO5CODE_USA","0","8","-1"
"1959","EEO5CODE_USA","0","9","-1"
"1960","EEO5CODE_USA","0","N","-1"
"1961","ProductType","0","T1","-1"
"1962","ProductType","0","T2","-1"
"1963","ProductType","0","T3","-1"
"1964","ProductType","0","T4","-1"
"1965","REGTEMP","0","1","-1"
"1966","REGTEMP","0","2","-1"
"1967","ecPhoneType","0","H","-1"
"1968","ecPhoneType","0","B","-1"
"1969","ecPhoneType","0","C","-1"
"1970","ecPhoneType","0","O","-1"
"1971","ecPhoneType","0","F","-1"
"1972","ecPhoneType","0","PC","-1"
"1973","yesNo","0","N","0"
"1974","yesNo","0","Y","1"
"1975","RUNTYPE","0","PAY","-1"
"1976","RUNTYPE","0","BEN","-1"
"1977","RUNTYPE","0","INC","-1"
"1978","SOCCODE_GBR","0","411","-1"
"1979","SOCCODE_GBR","0","421","-1"
"1980","SOCCODE_GBR","0","422","-1"
"1981","SOCCODE_GBR","0","423","-1"
"1982","SOCCODE_GBR","0","424","-1"
"1983","SOCCODE_GBR","0","312","-1"
"1984","SOCCODE_GBR","0","331","-1"
"1985","SOCCODE_GBR","0","332","-1"
"1986","SOCCODE_GBR","0","333","-1"
"1987","SOCCODE_GBR","0","334","-1"
"1988","SOCCODE_GBR","0","335","-1"
"1989","SOCCODE_GBR","0","351","-1"
"1990","SOCCODE_GBR","0","352","-1"
"1991","SOCCODE_GBR","0","353","-1"
"1992","SOCCODE_GBR","0","354","-1"
"1993","SOCCODE_GBR","0","241","-1"
"1994","SOCCODE_GBR","0","242","-1"
"1995","SOCCODE_GBR","0","261","-1"
"1996","SOCCODE_GBR","0","262","-1"
"1997","SOCCODE_GBR","0","271","-1"
"1998","SOCCODE_GBR","0","272","-1"
"1999","SOCCODE_GBR","0","281","-1"
"2000","SOCCODE_GBR","0","282","-1"
"2001","SOCCODE_GBR","0","191","-1"
"2002","SOCCODE_GBR","0","192","-1"
"2003","employee-status","0","A","-1"
"2004","employee-status","0","U","-1"
"2005","employee-status","0","P","-1"
"2006","employee-status","0","R","-1"
"2007","employee-status","0","S","-1"
"2008","employee-status","0","T","-1"
"2009","employee-status","0","F","-1"
"2010","employee-status","0","O","-1"
"2011","PTOLEVEL","0","LEV19","-1"
"2012","PTOLEVEL","0","LEV24","-1"
"2013","PTOLEVEL","0","LEV27","-1"
"2014","PTOLEVEL","0","LEV30","-1"
"2015","PTOLEVEL","0","LEV33","-1"
"2016","EEO1CODE_USA","0","1","-1"
"2017","EEO1CODE_USA","0","2","-1"
"2018","EEO1CODE_USA","0","3","-1"
"2019","EEO1CODE_USA","0","4","-1"
"2020","EEO1CODE_USA","0","5","-1"
"2021","EEO1CODE_USA","0","6","-1"
"2022","EEO1CODE_USA","0","7","-1"
"2023","EEO1CODE_USA","0","8","-1"
"2024","EEO1CODE_USA","0","9","-1"
"2025","EEO1CODE_USA","0","N","-1"
"2026","EEO1CODE_USA","0","0","-1"
"2027","typeOfChallenge","0","1","-1"
"2028","typeOfChallenge","0","2","-1"
"2029","typeOfChallenge","0","3","-1"
"2030","TAXSTATUS_CHE","0","0","-1"
"2031","TAXSTATUS_CHE","0","1","-1"
"2032","TAXSTATUS_CHE","0","2","-1"
"2033","TAXSTATUS_CHE","0","3","-1"
"2034","EMPLOYEECLASS","0","WORKEXP","-1"
"2035","EMPLOYEECLASS","0","EXTERNAL","-1"
"2036","EMPLOYEECLASS","0","CONTRACT","-1"
"2037","EMPLOYEECLASS","0","AGENCY","-1"
"2038","EMPLOYEECLASS","0","CONTRACT","-1"
"2039","EMPLOYEECLASS","0","CONSULT","-1"
"2040","EMPLOYEECLASS","0","AGCONSULT","-1"
"2041","EMPLOYEECLASS","0","EMPLOYEE","-1"
"2042","ISOCountryList","0","AFG","-1"
"2043","ISOCountryList","0","ALB","-1"
"2044","ISOCountryList","0","DZA","-1"
"2045","ISOCountryList","0","ASM","-1"
"2046","ISOCountryList","0","AND","-1"
"2047","ISOCountryList","0","AGO","-1"
"2048","ISOCountryList","0","AIA","-1"
"2049","ISOCountryList","0","ATA","-1"
"2050","ISOCountryList","0","ATG","-1"
"2051","ISOCountryList","0","ARG","-1"
"2052","ISOCountryList","0","ARM","-1"
"2053","ISOCountryList","0","ABW","-1"
"2054","ISOCountryList","0","AUS","-1"
"2055","ISOCountryList","0","AUT","-1"
"2056","ISOCountryList","0","AZE","-1"
"2057","ISOCountryList","0","BHS","-1"
"2058","ISOCountryList","0","BHR","-1"
"2059","ISOCountryList","0","BGD","-1"
"2060","ISOCountryList","0","BRB","-1"
"2061","ISOCountryList","0","BLR","-1"
"2062","ISOCountryList","0","BEL","-1"
"2063","ISOCountryList","0","BLZ","-1"
"2064","ISOCountryList","0","BEN","-1"
"2065","ISOCountryList","0","BMU","-1"
"2066","ISOCountryList","0","BTN","-1"
"2067","ISOCountryList","0","BOL","-1"
"2068","ISOCountryList","0","BIH","-1"
"2069","ISOCountryList","0","BWA","-1"
"2070","ISOCountryList","0","BVT","-1"
"2071","ISOCountryList","0","BRA","-1"
"2072","ISOCountryList","0","IOT","-1"
"2073","ISOCountryList","0","BRN","-1"
"2074","ISOCountryList","0","BGR","-1"
"2075","ISOCountryList","0","BFA","-1"
"2076","ISOCountryList","0","BDI","-1"
"2077","ISOCountryList","0","KHM","-1"
"2078","ISOCountryList","0","CMR","-1"
"2079","ISOCountryList","0","CAN","-1"
"2080","ISOCountryList","0","CPV","-1"
"2081","ISOCountryList","0","CYM","-1"
"2082","ISOCountryList","0","CAF","-1"
"2083","ISOCountryList","0","TCD","-1"
"2084","ISOCountryList","0","CHL","-1"
"2085","ISOCountryList","0","CHN","-1"
"2086","ISOCountryList","0","CXR","-1"
"2087","ISOCountryList","0","CCK","-1"
"2088","ISOCountryList","0","COL","-1"
"2089","ISOCountryList","0","COM","-1"
"2090","ISOCountryList","0","COG","-1"
"2091","ISOCountryList","0","COD","-1"
"2092","ISOCountryList","0","COK","-1"
"2093","ISOCountryList","0","CRI","-1"
"2094","ISOCountryList","0","HRV","-1"
"2095","ISOCountryList","0","CUB","-1"
"2096","ISOCountryList","0","CYP","-1"
"2097","ISOCountryList","0","CZE","-1"
"2098","ISOCountryList","0","CIV","-1"
"2099","ISOCountryList","0","DNK","-1"
"2100","ISOCountryList","0","DJI","-1"
"2101","ISOCountryList","0","DMA","-1"
"2102","ISOCountryList","0","DOM","-1"
"2103","ISOCountryList","0","ECU","-1"
"2104","ISOCountryList","0","EGY","-1"
"2105","ISOCountryList","0","SLV","-1"
"2106","ISOCountryList","0","GNQ","-1"
"2107","ISOCountryList","0","ERI","-1"
"2108","ISOCountryList","0","EST","-1"
"2109","ISOCountryList","0","ETH","-1"
"2110","ISOCountryList","0","FLK","-1"
"2111","ISOCountryList","0","FRO","-1"
"2112","ISOCountryList","0","FJI","-1"
"2113","ISOCountryList","0","FIN","-1"
"2114","ISOCountryList","0","FRA","-1"
"2115","ISOCountryList","0","GUF","-1"
"2116","ISOCountryList","0","PYF","-1"
"2117","ISOCountryList","0","ATF","-1"
"2118","ISOCountryList","0","GAB","-1"
"2119","ISOCountryList","0","GMB","-1"
"2120","ISOCountryList","0","GEO","-1"
"2121","ISOCountryList","0","DEU","-1"
"2122","ISOCountryList","0","GHA","-1"
"2123","ISOCountryList","0","GIB","-1"
"2124","ISOCountryList","0","GRC","-1"
"2125","ISOCountryList","0","GRL","-1"
"2126","ISOCountryList","0","GRD","-1"
"2127","ISOCountryList","0","GLP","-1"
"2128","ISOCountryList","0","GUM","-1"
"2129","ISOCountryList","0","GTM","-1"
"2130","ISOCountryList","0","GGY","-1"
"2131","ISOCountryList","0","GIN","-1"
"2132","ISOCountryList","0","GNB","-1"
"2133","ISOCountryList","0","GUY","-1"
"2134","ISOCountryList","0","HTI","-1"
"2135","ISOCountryList","0","HMD","-1"
"2136","ISOCountryList","0","VAT","-1"
"2137","ISOCountryList","0","HND","-1"
"2138","ISOCountryList","0","HKG","-1"
"2139","ISOCountryList","0","HUN","-1"
"2140","ISOCountryList","0","ISL","-1"
"2141","ISOCountryList","0","IND","-1"
"2142","ISOCountryList","0","IDN","-1"
"2143","ISOCountryList","0","IRN","-1"
"2144","ISOCountryList","0","IRQ","-1"
"2145","ISOCountryList","0","IRL","-1"
"2146","ISOCountryList","0","IMN","-1"
"2147","ISOCountryList","0","ISR","-1"
"2148","ISOCountryList","0","ITA","-1"
"2149","ISOCountryList","0","JAM","-1"
"2150","ISOCountryList","0","JPN","-1"
"2151","ISOCountryList","0","JEY","-1"
"2152","ISOCountryList","0","JOR","-1"
"2153","ISOCountryList","0","KAZ","-1"
"2154","ISOCountryList","0","KEN","-1"
"2155","ISOCountryList","0","KIR","-1"
"2156","ISOCountryList","0","PRK","-1"
"2157","ISOCountryList","0","KOR","-1"
"2158","ISOCountryList","0","KWT","-1"
"2159","ISOCountryList","0","KGZ","-1"
"2160","ISOCountryList","0","LAO","-1"
"2161","ISOCountryList","0","LVA","-1"
"2162","ISOCountryList","0","LBN","-1"
"2163","ISOCountryList","0","LSO","-1"
"2164","ISOCountryList","0","LBR","-1"
"2165","ISOCountryList","0","LBY","-1"
"2166","ISOCountryList","0","LIE","-1"
"2167","ISOCountryList","0","LTU","-1"
"2168","ISOCountryList","0","LUX","-1"
"2169","ISOCountryList","0","MAC","-1"
"2170","ISOCountryList","0","MKD","-1"
"2171","ISOCountryList","0","MDG","-1"
"2172","ISOCountryList","0","MWI","-1"
"2173","ISOCountryList","0","MYS","-1"
"2174","ISOCountryList","0","MDV","-1"
"2175","ISOCountryList","0","MLI","-1"
"2176","ISOCountryList","0","MLT","-1"
"2177","ISOCountryList","0","MHL","-1"
"2178","ISOCountryList","0","MTQ","-1"
"2179","ISOCountryList","0","MRT","-1"
"2180","ISOCountryList","0","MUS","-1"
"2181","ISOCountryList","0","MYT","-1"
"2182","ISOCountryList","0","MEX","-1"
"2183","ISOCountryList","0","FSM","-1"
"2184","ISOCountryList","0","MDA","-1"
"2185","ISOCountryList","0","MCO","-1"
"2186","ISOCountryList","0","MNG","-1"
"2187","ISOCountryList","0","MNE","-1"
"2188","ISOCountryList","0","MSR","-1"
"2189","ISOCountryList","0","MAR","-1"
"2190","ISOCountryList","0","MOZ","-1"
"2191","ISOCountryList","0","MMR","-1"
"2192","ISOCountryList","0","NAM","-1"
"2193","ISOCountryList","0","NRU","-1"
"2194","ISOCountryList","0","NPL","-1"
"2195","ISOCountryList","0","NLD","-1"
"2196","ISOCountryList","0","ANT","-1"
"2197","ISOCountryList","0","NCL","-1"
"2198","ISOCountryList","0","NZL","-1"
"2199","ISOCountryList","0","NIC","-1"
"2200","ISOCountryList","0","NER","-1"
"2201","ISOCountryList","0","NGA","-1"
"2202","ISOCountryList","0","NIU","-1"
"2203","ISOCountryList","0","NFK","-1"
"2204","ISOCountryList","0","MNP","-1"
"2205","ISOCountryList","0","NOR","-1"
"2206","ISOCountryList","0","OMN","-1"
"2207","ISOCountryList","0","PAK","-1"
"2208","ISOCountryList","0","PLW","-1"
"2209","ISOCountryList","0","PSE","-1"
"2210","ISOCountryList","0","PAN","-1"
"2211","ISOCountryList","0","PNG","-1"
"2212","ISOCountryList","0","PRY","-1"
"2213","ISOCountryList","0","PER","-1"
"2214","ISOCountryList","0","PHL","-1"
"2215","ISOCountryList","0","PCN","-1"
"2216","ISOCountryList","0","POL","-1"
"2217","ISOCountryList","0","PRT","-1"
"2218","ISOCountryList","0","PRI","-1"
"2219","ISOCountryList","0","QAT","-1"
"2220","ISOCountryList","0","ROU","-1"
"2221","ISOCountryList","0","RUS","-1"
"2222","ISOCountryList","0","RWA","-1"
"2223","ISOCountryList","0","REU","-1"
"2224","ISOCountryList","0","BLM","-1"
"2225","ISOCountryList","0","SHN","-1"
"2226","ISOCountryList","0","KNA","-1"
"2227","ISOCountryList","0","LCA","-1"
"2228","ISOCountryList","0","MAF","-1"
"2229","ISOCountryList","0","SPM","-1"
"2230","ISOCountryList","0","VCT","-1"
"2231","ISOCountryList","0","WSM","-1"
"2232","ISOCountryList","0","SMR","-1"
"2233","ISOCountryList","0","STP","-1"
"2234","ISOCountryList","0","SAU","-1"
"2235","ISOCountryList","0","SEN","-1"
"2236","ISOCountryList","0","SRB","-1"
"2237","ISOCountryList","0","SYC","-1"
"2238","ISOCountryList","0","SLE","-1"
"2239","ISOCountryList","0","SGP","-1"
"2240","ISOCountryList","0","SVK","-1"
"2241","ISOCountryList","0","SVN","-1"
"2242","ISOCountryList","0","SLB","-1"
"2243","ISOCountryList","0","SOM","-1"
"2244","ISOCountryList","0","ZAF","-1"
"2245","ISOCountryList","0","SGS","-1"
"2246","ISOCountryList","0","ESP","-1"
"2247","ISOCountryList","0","LKA","-1"
"2248","ISOCountryList","0","SDN","-1"
"2249","ISOCountryList","0","SUR","-1"
"2250","ISOCountryList","0","SJM","-1"
"2251","ISOCountryList","0","SWZ","-1"
"2252","ISOCountryList","0","SWE","-1"
"2253","ISOCountryList","0","CHE","-1"
"2254","ISOCountryList","0","SYR","-1"
"2255","ISOCountryList","0","TWN","-1"
"2256","ISOCountryList","0","TJK","-1"
"2257","ISOCountryList","0","TZA","-1"
"2258","ISOCountryList","0","THA","-1"
"2259","ISOCountryList","0","TLS","-1"
"2260","ISOCountryList","0","TGO","-1"
"2261","ISOCountryList","0","TKL","-1"
"2262","ISOCountryList","0","TON","-1"
"2263","ISOCountryList","0","TTO","-1"
"2264","ISOCountryList","0","TUN","-1"
"2265","ISOCountryList","0","TUR","-1"
"2266","ISOCountryList","0","TKM","-1"
"2267","ISOCountryList","0","TCA","-1"
"2268","ISOCountryList","0","TUV","-1"
"2269","ISOCountryList","0","UGA","-1"
"2270","ISOCountryList","0","UKR","-1"
"2271","ISOCountryList","0","ARE","-1"
"2272","ISOCountryList","0","GBR","-1"
"2273","ISOCountryList","0","USA","-1"
"2274","ISOCountryList","0","UMI","-1"
"2275","ISOCountryList","0","URY","-1"
"2276","ISOCountryList","0","UZB","-1"
"2277","ISOCountryList","0","VUT","-1"
"2278","ISOCountryList","0","VEN","-1"
"2279","ISOCountryList","0","VNM","-1"
"2280","ISOCountryList","0","VGB","-1"
"2281","ISOCountryList","0","VIR","-1"
"2282","ISOCountryList","0","WLF","-1"
"2283","ISOCountryList","0","ESH","-1"
"2284","ISOCountryList","0","YEM","-1"
"2285","ISOCountryList","0","ZMB","-1"
"2286","ISOCountryList","0","ZWE","-1"
"2287","ISOCountryList","0","ALA","-1"
"2301","permitdoctype","0","PDTGMT","-1"
"2302","permitdoctype","0","PDTFRA1","-1"
"2303","permitdoctype","0","PDTFRA2","-1"
"2304","permitdoctype","0","PDTFRA3","-1"
"2305","permitdoctype","0","PDTFRA4","-1"
"2306","permitdoctype","0","PDTFRA5","-1"
"2307","permitdoctype","0","PDTGBR1","-1"
"2308","permitdoctype","0","PDTGBR2","-1"
"2309","permitdoctype","0","PDTGBR2","-1"
"2310","permitdoctype","0","PDTGBR3","-1"
"2311","permitdoctype","0","PDTGBR4","-1"
"2312","permitdoctype","0","PDTGBR5","-1"
"2313","permitdoctype","0","PDTGBR6","-1"
"2314","permitdoctype","0","PDTGBR7","-1"
"2315","permitdoctype","0","PDTGBR8","-1"
"2316","permitdoctype","0","PDTGBR9","-1"
"2317","permitdoctype","0","PDTGBR10","-1"
"2318","permitdoctype","0","PDTGBR11","-1"
"2319","permitdoctype","0","PDTGBR12","-1"
"2320","permitdoctype","0","PDTGBR13","-1"
"2321","permitdoctype","0","PDTGBR14","-1"
"2322","permitdoctype","0","PDTGBR15","-1"
"2323","permitdoctype","0","PDTGBR16","-1"
"2324","permitdoctype","0","PDTGBR17","-1"
"2325","permitdoctype","0","PDTGBR18","-1"
"2326","permitdoctype","0","PDTGBR19","-1"
"2327","permitdoctype","0","PDTGBR20","-1"
"2328","permitdoctype","0","PDTGBR21","-1"
"2329","permitdoctype","0","PDTGBR22","-1"
"2330","permitdoctype","0","PDTSGP1","-1"
"2331","permitdoctype","0","PDTSGP2","-1"
"2332","permitdoctype","0","PDTSGP3","-1"
"2333","permitdoctype","0","PDTSGP4","-1"
"2334","permitdoctype","0","PDTSGP5","-1"
"2335","permitdoctype","0","PDTSGP6","-1"
"2336","permitdoctype","0","PDTSGP7","-1"
"2337","permitdoctype","0","PDTSGP8","-1"
"2338","permitdoctype","0","PDTSGP9","-1"
"2339","permitdoctype","0","PDTCHE1","-1"
"2340","permitdoctype","0","PDTCHE2","-1"
"2341","permitdoctype","0","PDTCHE3","-1"
"2342","permitdoctype","0","PDTCHE4","-1"
"2343","permitdoctype","0","PDTCHE5","-1"
"2344","permitdoctype","0","PDTIRE1","-1"
"2345","permitdoctype","0","PDTIRE2","-1"
"2346","permitdoctype","0","PDTIRE3","-1"
"2347","permitdoctype","0","PDTIRE4","-1"
"2348","permitdoctype","0","PDTIRE5","-1"
"2349","permitdoctype","0","PDTIRE6","-1"
"2350","permitdoctype","0","PDTIRE7","-1"
"2351","permitdoctype","0","PDTGER1","-1"
"2352","permitdoctype","0","PDTGER2","-1"
"2353","permitdoctype","0","PDTGER3","-1"
"2354","permitdoctype","0","PDTGER4","-1"
"2355","permitdoctype","0","PDTUSA1","-1"
"2356","permitdoctype","0","PDTUSA2","-1"
"2357","permitdoctype","0","PDTUSA3","-1"
"2358","permitdoctype","0","PDTUSA4","-1"
"2359","permitdoctype","0","PDTUSA5","-1"
"2360","permitdoctype","0","PDTUSA6","-1"
"2361","permitdoctype","0","PDTUSA7","-1"
"2362","permitdoctype","0","PDTUSA8","-1"
"2363","permitdoctype","0","PDTUSA9","-1"
"2364","permitdoctype","0","PDTUSA10","-1"
"2365","permitdoctype","0","PDTUSA11","-1"
"2366","permitdoctype","0","PDTUSA12","-1"
"2367","permitdoctype","0","PDTUSA13","-1"
"2368","permitdoctype","0","PDTUSA14","-1"
"2369","permitdoctype","0","PDTUSA15","-1"
"2370","permitdoctype","0","PDTUSA16","-1"
"2371","permitdoctype","0","PDTUSA17","-1"
"2372","permitdoctype","0","PDTUSA18","-1"
"2373","permitdoctype","0","PDTUSA19","-1"
"2374","permitdoctype","0","PDTUSA20","-1"
"2375","permitdoctype","0","PDTUSA21","-1"
"2376","permitdoctype","0","PDTUSA22","-1"
"2377","permitdoctype","0","PDTUSA23","-1"
"2378","permitdoctype","0","PDTUSA24","-1"
"2379","permitdoctype","0","PDTUSA25","-1"
"2380","permitdoctype","0","PDTUSA26","-1"
"2381","permitdoctype","0","PDTUSA27","-1"
"2382","permitdoctype","0","PDTUSA28","-1"
"2383","addressType","0","mailing","-1"
